form	lemma	POS morph
Herbelay	Herbelay	subordinating_conjunction
Gerardus	Gerardus	proper_noun
de	de	adposition
Beaunes	Beaunes	noun
scutiffer	scutuffer	noun
constitutus	constituo	verb
est	sum	auxiliary
procurator	procurator	noun
apud	apud	adposition
Herbelay	Herbelay	noun
ad	ad	adposition
requirendum	requiro	verb
et	et	coordinating_conjunction
prosequendum	prosequor	verb
homines	homo	noun
et	et	coordinating_conjunction
hospites	hospis	noun
capituli	capitulum	noun
Dionisius	Dionisius	proper_noun
Rigault	Rigault	verb
constitutus	constituo	verb
seu	siue	coordinating_conjunction
institutus	instituo	verb
prepositus	prepono	verb
ibidem	ibidem	adverb
pro	pro	adposition
capitulo	capitulum	noun
Philippus	Philippus	proper_noun
Paumier	Paumier	noun
institutus	instituo	verb
serviens	serviens	verb
capituli	capitulum	noun
ibidem	ibidem	adverb
Ordinatum	Ordino	verb
est	sum	auxiliary
quod	quod	subordinating_conjunction
domus	domus	noun
de	de	adposition
carceribus	carcer	noun
dicti	dico	verb
loci	locus	noun
d'Erbelay	d'Erbelay	adjective
reperetur	repero	verb
et	et	coordinating_conjunction
quod	quod	subordinating_conjunction
jura	jura	noun
et	et	coordinating_conjunction
redditus	reddo	verb
ecclesie	ecclesis	noun
ibidem	ibidem	adverb
tradantur	trado	verb
ad	ad	adposition
firmam	firmus	adjective
ut	ut	subordinating_conjunction
melius	bonus	adjective
et	et	coordinating_conjunction
utilius	utiliter	adverb
poterit	possum	verb
/	/	punctuation
et	et	coordinating_conjunction
de	de	adposition
hoc	hic	pronoun
oneratus	onero	verb
est	sum	auxiliary
De	De	adposition
Croces	Croces	noun
Herbelay	Herbelay	noun
Veneris	Veneris	noun
quinta	quintus	adjective
marcii	marcius	noun
capitulantibus	capitulo	verb
dominis	dominus	noun
.	.	punctuation
Sunt	Sunt	verb
xxx	xxx	numeral
valent	valent	verb
xx	xx	numeral
s.	s.	noun
Archidiacono	Archidiacono	noun
de	de	adposition
Josayo	Josayo	noun
J	J	numeral
.	.	punctuation
Fresnoy	Fresnoy	verb
Sohier	Sohier	adposition
Succentore	Succentore	noun
De	De	adposition
Croces	Croces	noun
P.	P.	numeral
Thomas	Thomas	proper_noun
Cancellario	Cancellario	adjective
Boullardi	Boullardi	noun
Victri	Victri	noun
Ordeimonte	Ordeimon	noun
Pion	Pion	punctuation
Mondidier	Mondidier	noun
C	C	numeral
hacy	hic	punctuation
Pion	Pion	punctuation
Bastardi	Bastardi	noun
Paillard	Paillard	verb
Breton	Breton	proper_noun
Fraxinis	Fraxinis	adjective
Aguenin	Aguenin	verb
Cotin	Cotin	punctuation
De	De	adposition
Brollio	Brollio	noun
excusato	excuso	verb
Gaillon	Gaillon	noun
Jerson	Jerson	punctuation
Confranc	Confranc	adposition
infirmo	infirmus	adjective
Barre	Barre	noun
Melloti	Melloti	noun
Haultny	Haultny	verb
De	De	adposition
Courcellis	Courcellis	noun
Bussi	Bussi	punctuation
Vayli	Vayli	verb
Capellania	Capellania	noun
ad	ad	adposition
altare	altare	noun
Sannti	Sannti	noun
Eutropii	Eutropii	noun
quam	qui	pronoun
nuper	nuper	adverb
obtinebat	obtineo	verb
in	in	adposition
ecclesia	ecclesia	noun
Par.	Par.	other
G	G	numeral
.	.	punctuation
De	De	adposition
Croces	Croces	noun
vacans	vacans	verb
ad	ad	adposition
presens	presum	verb
per	per	adposition
resignacionem	resignacio	noun
m.	m.	other
V.	V.	numeral
de	de	adposition
Croces	Croces	noun
ejus	ejus	determiner
procuratoris	procurator	noun
ad	ad	adposition
hoc	hic	pronoun
potestatem	potestas	noun
habentis	habeo	verb
ex	ex	adposition
causa	causa	noun
permutacionis	permutacio	noun
et	et	coordinating_conjunction
non	non	particle
alias	alius	pronoun
faciendo	facio	verb
cum	cum	adposition
magistro	magister	noun
Johanne	Johanne	proper_noun
Bacularii	Bacularii	adjective
consiliario	consiliarius	adjective
regis	rex	noun
ad	ad	adposition
capellaniam	capellania	noun
Sancti	Sancti	adjective
Georgii	Georgii	proper_noun
in	in	adposition
ecclesia	ecclesia	noun
Beate	Beate	noun
Marie	Marie	noun
Magdalene	Magdalene	adjective
de	de	adposition
Magduno	Magduno	noun
Salvo	Salvo	adjective
jure	jure	noun
cujuslibet	quilibet	pronoun
collata	confero	verb
est	sum	auxiliary
dicto	dico	verb
magistro	magister	noun
Jo	Jo	noun
.	.	punctuation
Bacularii	Bacularii	noun
in	in	adposition
persona	persona	noun
m.	m.	numeral
Jo	Jo	noun
.	.	punctuation
Bastardi	Bastardi	noun
ejus	ejus	determiner
procuratoris	procurator	noun
ad	ad	adposition
hoc	hic	pronoun
fundati	fundo	verb
/	/	punctuation
qui	qui	pronoun
juravit	juravit	verb
in	in	adposition
forma	forma	noun
et	et	coordinating_conjunction
fuit	sum	auxiliary
installatus	installo	verb
prestito	presto	verb
prius	prius	adverb
juramento	juramento	noun
per	per	adposition
dictos	dico	verb
procuratores	procurator	noun
nominibus	nomen	noun
predictis	predico	verb
quod	quod	subordinating_conjunction
in	in	adposition
hujusmodi	hujusmodi	adverb
resignacione	resignacio	noun
non	non	particle
intervenient	intervenient	verb
fraus	fraus	noun
dolus	dolus	noun
etc	isc	punctuation
Hodie	Hodie	adverb
in	in	adposition
capitulo	capitulum	noun
Par.	Par.	other
Gilectus	Gilectus	verb
Hemon	Hemon	auxiliary
molendinus	molendo	verb
tenens	teneo	verb
molendinum	molendo	verb
de	de	adposition
Cristollio	Cristollio	noun
pro	pro	adposition
octo	octo	numeral
annis	annus	noun
ut	ut	subordinating_conjunction
dicitur	dico	verb
de	de	adposition
quibus	qui	pronoun
sunt	sum	verb
jam	jam	adverb
iiiior	iiiior	noun
elapsi	elabor	verb
/	/	punctuation
et	et	coordinating_conjunction
iiiior	iiiior	punctuation
venturus	venturus	verb
peciit	pecio	verb
et	et	coordinating_conjunction
requisivit	requiro	verb
quod	quod	subordinating_conjunction
forum	forum	noun
suum	suus	determiner
sibi	se	pronoun
teneatur	teneo	verb
de	de	adposition
dicto	dico	verb
molendino	molendino	verb
aut	aut	coordinating_conjunction
De	De	adposition
molendino	molendino	verb
quod	quod	subordinating_conjunction
recompensetur	recompenso	verb
$antequam	$antequam	noun
$	$	verb
de	de	adposition
suis	suus	determiner
dampnis	dampnum	noun
etc.	etc.	other
antequam	antequam	subordinating_conjunction
tradatur	trado	verb
G	G	noun
Parisot	Parisot	noun
de	de	adposition
Cristallio	Cristallio	noun
Super	Super	adposition
quo	qui	pronoun
ordinatum	ordino	verb
est	sum	auxiliary
quod	quod	subordinating_conjunction
primo	primo	adverb
videatur	videatur	verb
in	in	adposition
quo	qui	pronoun
statu	status	noun
est	sum	auxiliary
molendinum	molendo	verb
predictum	predico	verb
et	et	coordinating_conjunction
secundum	secundum	adposition
quod	quod	subordinating_conjunction
videbitur	videbitur	verb
tractabitur	tracto	verb
cum	cum	adposition
dicto	dico	verb
Egidio	Egidio	noun
si	si	subordinating_conjunction
possit	possum	verb
fieri	facio	verb
sinantem	sino	verb
habentur	habeo	verb
oppinio	oppinio	noun
consilii	consilium	noun
ecclesie	ecclesies	proper_noun
et	et	coordinating_conjunction
ad	ad	adposition
hoc	hic	pronoun
deputatus	deputo	verb
est	sum	auxiliary
ᗞe	ᗞe	punctuation
Croces	Croces	coordinating_conjunction
officiarius	officiarius	adjective
collacio	collacium	noun
capellanie	capellanis	noun
ecclesie	ecclesis	noun
Par.	Par.	noun
