form	lemma	POS morph
33	33	numeral
.	.	punctuation
Hodie	Hodie	adverb
comparuerunt	compareo	verb
in	in	adposition
capitulo	capitulum	noun
Par.	Par.	noun
magistri	magister	noun
Bursarius	Bursarius	adjective
.	.	punctuation
Sy.	Sy.	noun
P	P	numeral
.	.	punctuation
Petit	Petit	verb
De	De	adposition
religiosis	religiosus	adjective
Thoulouse	Thoulouse	noun
et	et	coordinating_conjunction
Gauffridus	Gauffridus	adjective
religiosi	religiosus	adjective
domus	domus	noun
Dei	Dei	proper_noun
Par.	Par.	noun
/	/	adposition
Quibus	Quibus	pronoun
dictum	dico	verb
est	sum	auxiliary
domus	domus	noun
Dei	Dei	proper_noun
Par.	Par.	adverb
quod	qui	pronoun
de	de	adposition
cetero	ceterus	pronoun
fuit	sum	auxiliary
melius	bonus	adjective
regiminis	regimen	noun
quam	quam	subordinating_conjunction
fuerit	sum	verb
alias	alius	pronoun
punientur	punio	verb
per	per	adposition
capitulum	capitulum	noun
de	de	adposition
scolaribus	scolarus	adjective
xviii	xviii	noun
scolarium	scolarius	adjective
Hodie	Hodie	adverb
dominus	dominus	noun
Succentor	Succentor	noun
solvit	solvit	verb
$solvi$	$solvi$	punctuation
scolaribus	scolarus	adjective
collegii	collegium	noun
xviii	xviii	noun
scolarium	scolarius	adjective
vi	vi	punctuation
albos	albus	adjective
Succentore	Succentore	noun
per	per	adposition
sex	sex	numeral
diebus	dies	noun
Quadragesime	Quadragesime	adverb
secundum	secundum	adposition
ordini	ordo	noun
capituli	capitulum	noun
Pion	Pion	punctuation
deputantur	deputo	verb
ad	ad	adposition
videndum	videndum	verb
domus	domus	noun
videlicet	videlicet	verb
domum	domus	noun
que	que	coordinating_conjunction
fuit	sum	auxiliary
Henrici	Henrici	proper_noun
de	de	adposition
la	la	noun
Porte	Porte	noun
Commissi	Commissi	noun
pro	pro	adposition
domibus	domus	noun
Fraxinis	Fraxinis	adjective
in	in	adposition
vico	vico	noun
dela	dela	noun
Vennerie	Vennerie	noun
/	/	numeral
domum	domus	noun
in	in	adposition
vico	vico	noun
Sancti	Sancti	adjective
Jacobi	Jacobi	proper_noun
ad	ad	adposition
intersignum	intersignus	noun
de	de	adposition
pro	pro	adposition
priorissa	priorissus	adjective
domus	domus	noun
Dei	Dei	proper_noun
l'ᗅrbaleste	l'ᗅrbaleste	adjective
domum	domus	noun
de	de	adposition
la	la	noun
Cloche	Cloche	noun
/	/	punctuation
et	et	coordinating_conjunction
domum	domus	noun
in	in	adposition
vico	vico	noun
des	des	noun
Deschargeurs	Deschargeurs	adjective
que	que	coordinating_conjunction
fuit	sum	verb
Margare	Margare	verb
de	de	adposition
Louvers	Louvers	noun
.	.	punctuation
pro	pro	adposition
priossa	priossus	noun
Domus	Domus	noun
Dei	Dei	proper_noun
par.	par.	adverb
cccc.	cccc.	noun
l.	l.	noun
Mercurii	Mercurii	noun
sancta	sanctus	noun
xxi	xxi	numeral
aprilis	aprila	noun
capitulantibus	capitulo	verb
dominis	dominus	noun
Archidiacono	Archidiacono	noun
de	de	adposition
Josayo	Josayo	noun
Fresnoy	Fresnoy	noun
P.	P.	numeral
Thomas	Thomas	proper_noun
Succentore	Succentore	noun
Penitenciario	Penitenciario	adjective
De	De	adposition
Croces	Croces	noun
Fraxinis	Fraxinis	adjective
Victri	Victri	punctuation
Despars	Despars	verb
Ordeimonte	Ordeimon	noun
de	de	adposition
Brollio	Brollio	noun
Guerinet	Guerinet	verb
C	C	punctuation
hacy	hic	punctuation
Aguenin	Aguenin	verb
Jerson	Jerson	adposition
Breton	Breton	proper_noun
Melloti	Melloti	noun
De	De	adposition
Courcellis	Courcellis	noun
Cotin	Cotin	punctuation
Gaillon	Gaillon	noun
Boullardi	Boullardi	noun
Cancellario	Cancellario	adjective
}	}	adposition
infirmis	infirmis	adjective
Bastardi	Bastardi	noun
Confranc	Confranc	punctuation
Haultny	Haultny	verb
Pion	Pion	punctuation
Paillard	Paillard	verb
}	}	adposition
excusatis	excuso	verb
Du	Du	punctuation
Drac	Drac	punctuation
Sohier	Sohier	verb
Barre	Barre	noun
Capellania	Capellania	adjective
ad	ad	adposition
altare	altare	noun
Sancti	Sancti	adjective
Michaelis	Michaelis	proper_noun
in	in	adposition
ecclesia	ecclesia	noun
Par.	Par.	noun
vacans	vacans	verb
pro	pro	adposition
resigiaionm	resigiais	noun
m.	m.	numeral
Jo	Jo	noun
.	.	punctuation
Godart	Godart	noun
eiusdem	idem	pronoun
ultimi	ultimus	adjective
capellani	capellanus	noun
et	et	coordinating_conjunction
possessonis	possessonus	noun
excusa	excudo	verb
permutacionis	permutacio	noun
et	et	coordinating_conjunction
non	non	particle
alias	alius	pronoun
faciende	facio	verb
cum	cum	adposition
domino	dominus	noun
Johanne	Johanne	proper_noun
du	du	punctuation
Transbel	Transbel	adposition
canonico	canonicus	noun
Ambiacensi	Ambiacensi	adjective
ad	ad	adposition
parrochialem	parrochialis	adjective
ecclesiam	ecclesia	noun
beate	beate	adverb
Marie	Marie	noun
de	de	adposition
Boulonnia	Boulonnia	noun
parva	parva	adjective
diocesis	diocesis	noun
Par	Par	adjective
.	.	punctuation
collata	confero	verb
est	sum	auxiliary
Salvo	Salvo	adjective
jure	jure	noun
cujuslibet	quilibet	pronoun
dicto	dico	verb
domino	dominus	noun
Johanne	Johanne	proper_noun
du	du	numeral
Translel	Translel	verb
in	in	adposition
personam	persona	noun
ejus	ejus	determiner
procuratoris	procurator	noun
qui	qui	pronoun
juravit	juravit	verb
in	in	adposition
forma	forma	noun
Hodie	Hodie	adverb
magister	magister	proper_noun
Dyonisius	Dyonisius	adjective
Le	Le	punctuation
Herpeur	Herpeur	verb
nomine	nomen	noun
domini	dominus	noun
G	G	noun
.	.	punctuation
nunc	nunc	adverb
episcopi	episcopus	noun
Parisinsis	Parisinsis	noun
tradidit	trado	verb
xxx	xxx	numeral
l.	l.	noun
tradit	trado	verb
ex	ex	adposition
parte	pars	noun
in	in	adposition
capitulo	capitulum	noun
Par.	Par.	noun
xxx	xxx	numeral
l.	l.	noun
s	s	numeral
.	.	punctuation
tam	tam	adverb
pro	pro	adposition
capellanis	capellanus	adjective
communitatis	communitas	noun
quam	quam	subordinating_conjunction
pro	pro	adposition
clericis	clericus	noun
matutinarum	matutinus	adjective
requirentis	requiro	verb
Par.	Par.	noun
pro	pro	adposition
capellano	capellanus	noun
clericis	clericus	adjective
matutinarum	matutinus	adjective
dominos	dominus	noun
quatinus	quatinus	subordinating_conjunction
dictam	dico	verb
summam	summus	adjective
distribuerent	distribuo	verb
prout	prout	subordinating_conjunction
eis	is	pronoun
vdetur	vdetur	verb
expediens	expedio	verb
et	et	coordinating_conjunction
hoc	hic	pronoun
propter	propter	adposition
debatum	debatum	noun
parcium	parcium	noun
/	/	punctuation
Et	Et	coordinating_conjunction
ibidem	ibidem	adverb
dominus	dominus	noun
P.	P.	numeral
de	de	adposition
Cajart	Cajart	noun
prout	prout	subordinating_conjunction
dictorum	dico	verb
clericorum	clericus	noun
injuctum	injuctum	verb
est	sum	auxiliary
eidem	idem	pronoun
ne	ne	subordinating_conjunction
procedat	procedo	verb
ulterius	ultra	adverb
occasione	occasio	noun
huius	hic	determiner
rei	res	noun
contra	contra	adposition
dictum	dico	verb
dominum	dominus	noun
episcopum	episcopus	noun
Collacio	Collacio	noun
capellanie	capellanis	adjective
