form	lemma	POS morph
Brevedent	Brevedent	verb
Super	Super	adposition
suplicacione	suplicacio	noun
magistri	magister	noun
Johannis	Johannis	proper_noun
Brevedent	Brevedent	verb
solicitatoris	solicitas	noun
processuum	processus	noun
ecclesie	ecclesis	noun
petenti	peto	verb
solvi	solvi	verb
per	per	adposition
officiarium	officias	adjective
matutinarum	matutinus	adjective
de	de	adposition
summa	summus	adjective
viginti	viginti	numeral
solidorum	solidus	noun
Par	Par	adjective
.	.	punctuation
pro	pro	adposition
suis	suus	determiner
stipendiis	stipendium	noun
Ordinatum	Ordino	verb
est	sum	auxiliary
quod	quod	subordinating_conjunction
habeat	habeo	verb
decem	decem	numeral
solidos	solidus	noun
Par.	Par.	noun
capiendos	capio	verb
super	super	adposition
vadiis	vadiis	noun
magistri	magister	noun
Johannis	Johannis	proper_noun
Lengloys	Lengloys	noun
alterius	alter	determiner
solicitatorum	solicitas	noun
processuum	processus	noun
eo	is	pronoun
quod	quod	subordinating_conjunction
dictus	dico	verb
Langloys	Langloys	noun
recepit	recipio	verb
xx	xx	numeral
s.	s.	noun
p.	p.	noun
pro	pro	adposition
se	se	pronoun
et	et	coordinating_conjunction
dicto	dico	verb
Brevedent	Brevedent	verb
Commissi	Commissi	verb
fuerunt	sum	auxiliary
domini	dominus	noun
succentor	succentor	noun
et	et	coordinating_conjunction
Chasteaupers	Chasteaupers	verb
ad	ad	adposition
fieri	facio	verb
faciendum	facio	verb
De	De	adposition
domo	domus	noun
du	du	punctuation
reparaciones	reparacio	noun
circa	circa	adposition
stilicidia	stilicidium	noun
domus	domus	noun
intersignii	intersignius	adjective
du	du	punctuation
faucon	faucon	noun
sita	sino	verb
Faucon	Faucon	punctuation
in	in	adposition
vico	vico	noun
veteris	veteris	noun
monete	monete	adverb
capitulo	capitulum	noun
spectantis	specto	verb
Solvat	Solvat	verb
magister	magister	proper_noun
Petrus	Petrus	proper_noun
Pinagot	Pinagot	verb
officiarius	officiarius	adjective
anniversariorum	anniversariorum	adjective
magistro	magister	noun
Johanni	Johanni	noun
Mangendie	Mangendie	verb
summam	summus	adjective
duodecim	duodecim	numeral
solidorum	solidus	noun
octo	octo	numeral
denarios	denarius	noun
Par.	Par.	adverb
Mandatum	Mandatum	verb
pro	pro	adposition
per	per	adposition
ipsum	ipse	pronoun
Mangendie	Mangendie	verb
traditam	trado	verb
priori	prior	adjective
Sancti	Sancti	adjective
Eligii	Eligii	noun
pro	pro	adposition
certis	certus	adjective
magistro	magister	noun
Jo	Jo	noun
.	.	punctuation
Mangendie	Mangendie	verb
arreragiis	arreragium	noun
decem	decem	numeral
novem	novem	numeral
denarios	denarius	noun
Par.	Par.	adverb
census	census	noun
super	super	adposition
domo	domus	noun
in	in	adposition
qua	qui	pronoun
nunc	nunc	adverb
moratur	moror	verb
prope	prope	adposition
Sanctam	Sanctam	verb
Marinam	Marinam	noun
sitam	sino	verb
Mercurii	Mercurii	proper_noun
xxa	xxa	punctuation
novembris	novembris	noun
nonagesimo	nonagesimo	adverb
ordinarie	ordinarie	adverb
capitulantibus	capitulo	verb
dominis	dominus	noun
Ruzé	Ruzé	punctuation
Decano	Decano	noun
Condurier	Condurier	noun
sz	sz	noun
.	.	punctuation
Cantore	Cantore	noun
sz	sz	noun
Compains	Compains	noun
Gamay	Gamay	adposition
Archidiacono	Archidiacono	noun
Par.	Par.	noun
Samsonis	Samsonis	noun
sz	sz	noun
.	.	punctuation
Besançon	Besançon	noun
sz	sz	punctuation
Louet	Louet	verb
sz	sz	punctuation
Parpas	Parpas	noun
Archidiacono	Archidiacono	noun
Josas	Josas	noun
Damet	Damet	punctuation
Gaignon	Gaignon	noun
sz	sz	punctuation
Succentore	Succentore	noun
sz	sz	punctuation
Bourcier	Bourcier	noun
Briçonnet	Briçonnet	verb
Cancellario	Cancellario	adjective
Hacque	Hacque	pronoun
ville	ville	noun
Poncher	Poncher	punctuation
Penitenciario	Penitenciario	noun
sz	sz	punctuation
Legay	Legay	punctuation
Gobaille	Gobaille	verb
sz	sz	noun
Louviers	Louviers	noun
sz	sz	noun
.	.	punctuation
Lailly	Lailly	noun
sz	sz	numeral
.	.	punctuation
Emery	Emery	numeral
sz	sz	numeral
Picart	Picart	verb
sz	sz	noun
.	.	punctuation
Saulay	Saulay	noun
.	.	punctuation
Paris	Paris	noun
sz	sz	numeral
Censay	Censay	punctuation
sz	sz	numeral
Bellay	Bellay	numeral
Juvenal	Juvenal	noun
Samxon	Samxon	numeral
.	.	punctuation
Reffuge	Reffuge	noun
sz	sz	numeral
Menart	Menart	verb
.	.	punctuation
Claustre	Claustre	verb
sz	sz	noun
L'Enfant	L'Enfant	verb
sz	sz	noun
.	.	punctuation
Fabry	Fabry	numeral
sz	sz	numeral
Chasteaupers	Chasteaupers	verb
sz	sz	numeral
.	.	punctuation
Michel	Michel	numeral
sz	sz	numeral
.	.	punctuation
Basin	Basin	noun
sz	sz	punctuation
Tradat	Tradat	verb
magister	magister	proper_noun
Guillermus	Guillermus	noun
Condurier	Condurier	noun
super	super	adposition
revenuta	revenuta	noun
archidiaconatus	archidiaco	verb
Mandatum	Mandatum	verb
pro	pro	adposition
pueris	puer	noun
Brye	Brye	punctuation
nuper	nuper	adverb
vacante	vacante	verb
et	et	coordinating_conjunction
in	in	adposition
manu	manus	noun
capituli	capitulum	noun
existentis	exsisto	verb
pecunias	pecunia	noun
pro	pro	adposition
chori	chor	noun
emendo	emo	verb
duas	duo	numeral
cappas	cappa	noun
duobus	duo	numeral
pueris	puer	noun
chori	chor	noun
loco	locus	noun
aliarum	alius	determiner
in	in	adposition
domo	domus	noun
magistri	magister	noun
puerorum	puer	noun
chori	chor	noun
perditarum	perdo	verb
Visis	Visis	adjective
licteris	linio	verb
procuratoriis	procuratorius	adjective
magistri	magister	noun
Stephani	Stephani	proper_noun
Farcilly	Farcilly	punctuation
capellani	capellanus	noun
Admissio	Admissio	noun
resignacionis	resignacio	noun
capellanie	capellanis	adjective
sanctorum	sanctus	adjective
Bartholomei	Bartholomei	proper_noun
et	et	coordinating_conjunction
Vincencii	Vincencii	proper_noun
in	in	adposition
ecclesia	ecclesia	noun
Par.	Par.	noun
fundate	fundate	adverb
capellanie	capellanis	noun
in	in	adposition
ecclesia	ecclesia	noun
Placet	Placet	verb
admictere	admicio	verb
resignacionem	resignacio	noun
dicte	dico	verb
capellanie	capellanis	adjective
per	per	adposition
magistrum	magister	noun
Par.	Par.	other
fundate	fundo	verb
Germanum	Germanum	adjective
Guyin	Guyin	adposition
procuratorem	procurator	noun
dicti	dico	verb
Farcilly	Farcilly	adposition
factam	facio	verb
causa	causa	noun
permutacionis	permutacio	noun
cum	cum	adposition
magistro	magister	noun
Roberto	Roberto	proper_noun
de	de	adposition
Gremont	Gremont	noun
ad	ad	adposition
capellaniam	capellania	noun
Sancte	Sancte	adverb
Margarite	Margarite	verb
in	in	adposition
ecclesia	ecclesia	noun
Sancti	Sancti	adjective
T	T	noun
home	him	punctuation
de	de	adposition
Lupera	Lupera	noun
fundatam	fundo	verb
prout	prout	subordinating_conjunction
admissa	admitto	verb
fuit	sum	auxiliary
.	.	punctuation
Tertio	Tertio	noun
19	19	numeral
.	.	punctuation
