form	lemma	POS morph
471	@card@	INT
commissi	committo unir, entreprendre, rendre exÃ©cutoire, risquer, administrer (un sacrement), compromettre, produire, enjoindre, consigner, confier, perdre son droit sur une tenure par un dÃ©lit (ou une omission)	VBE
sunt	sum Ãªtre, exister, signifier Â¶ est : il est possible, il s'agit de	VBE
domini	dominus maÃ®tre, chef, seigneur, sire	SUB
condurier	condurier	VBE
et	et et	CON
compains	compains	VBE
ad	ad vers, pour, prÃ¨s de, chez, Ã , jusqu'Ã , relativement Ã , d'aprÃ¨s, par suite de	PRE
uidendum	uideo voir, comprendre, veiller Ã  Â¶ (pass.) Ãªtre vu, sembler	VBE
declaracionem	declaratio manifestation, montre, explication	SUB
per	per Ã  travers, par, tout le long de, durant, pendant, au cours de, par le moyen de, par suite de	PRE
prepositum	prepositus prÃ©vÃ´t, prieur, commandant	SUB
de	de de, du haut de, au cours de, immÃ©diatement aprÃ¨s, parmi	PRE
rosayo	rosayo	QLF
traditam	trado livrer, remettre, trahir, transmettre, enseigner, expliquer	VBE
de	de de, du haut de, au cours de, immÃ©diatement aprÃ¨s, parmi	PRE
reparacionibus	reparatio rÃ©tablissement, renouvellement	SUB
peo	peo	VBE
eum	is2 il, elle, le, la, les	PRO
factis	factum action, punition, redevance|factus exploitation, construction, quantitÃ© d'huile fournie par un tour de pressoir	SUB
qn	qn	SUB
dicto	dico2 dire, ordonner, chanter|dicto dicter, versifier, conseiller, dire souvent	VBE
loco	locus lieu, place, passage (d'un Ã©crit), localitÃ©, monastÃ¨re	SUB
soluat	soluo dÃ©lier, dÃ©livrer, acquitter, payer, rompre, relÃ¢cher, anÃ©antir, se dÃ©sister, renoncer Ã	VBE
officiarii	officiarium livre contenant les offices|officiarius officier, agent, official, membre d'une maison ecclÃ©siastique, serviteur, agent domanial, appariteur judiciaire	SUB
ecclesie	ecclesia assemblÃ©e, communautÃ© de fidÃ¨les, Ã©glise	SUB
modo	modo2 dans cette mesure, seulement, Ã  l'instant, tout de suite, rÃ©cemment, maintenant	ADV
consueto	consuetus habituel, accoutumÃ©	QLF
uadia	wadium gage, caution, contrat, salaire	SUB
magistri	magister2 maÃ®tre, bourgmestre, officier seigneurial	SUB
ioachin	-	NAM
henry	henry	SUB
solicitatori	sollicitator sÃ©ducteur	SUB
processuum	processus progression, progrÃ¨s, procÃ¨s	SUB
ecclesie	ecclesia assemblÃ©e, communautÃ© de fidÃ¨les, Ã©glise	SUB
pro	pro devant, en avant de, pour, en faveur de, Ã  la place de, en raison de	PRE
anno	annus annÃ©e, saison	SUB
ultimate	ultimo2 toucher Ã  sa fin	VBE
lapso	labor1 glisser, tomber, s'Ã©couler, se tromper, pÃ©cher|lapso glisser, tomber	VBE
ad	ad vers, pour, prÃ¨s de, chez, Ã , jusqu'Ã , relativement Ã , d'aprÃ¨s, par suite de	PRE
primum	primus premier, le plus important, Ã©minent	NUM
capitulum	capitulum petite tÃªte, tÃªte, capuchon, coiffure, chapiteau, chapitre, chevet	SUB
deliberabitur	delibero rÃ©flÃ©chir, dÃ©cider Â¶ libÃ©rer, rendre, payer, prÃªter (un serment)	VBE
super	super sur, au-dessus (de), prÃ¨s de, au sujet de, envers, contre, en plus de, plus que, Ã  cause de, pendant, sur, sous peine de, au risque de	PRE
requesta	requesta demande en justice	SUB
guillemi	-	NAM
de	de de, du haut de, au cours de, immÃ©diatement aprÃ¨s, parmi	PRE
saulx	saulx	NAM
scutiferi	scutifer Ã©cuyer	SUB
petente	peto se diriger vers, demander|petor obtenir	VBE
moderacio	moderatio mesure, modÃ©ration, gouvernement, administration, amÃ©nagement	SUB
sibi	se se, soi	PRO
fieri	fio se produire, se rencontrer, devenir, Ãªtre crÃ©Ã©	VBE
de	de de, du haut de, au cours de, immÃ©diatement aprÃ¨s, parmi	PRE
do	do donner, concÃ©der, lÃ©guer, exprimer	VBE
redditu	redditus2 remise, don, redevance|reditus retour, retraite, revenu, rÃ©volution (astre)	SUB
per	per Ã  travers, par, tout le long de, durant, pendant, au cours de, par le moyen de, par suite de	PRE
eum	is2 il, elle, le, la, les	PRO
debito	debitum dette, pÃ©chÃ©, tÃ¢che, amende, redevance, prÃ©bende, gage, nÃ©cessitÃ©	SUB
et	et et	CON
de	de de, du haut de, au cours de, immÃ©diatement aprÃ¨s, parmi	PRE
arreragiis	arrieragium arrÃ©rage	SUB
placet	placeo plaire|placo apaiser	VBE
dominis	domina dame|dominus maÃ®tre, chef, seigneur, sire	SUB
admictere	admictere	VBE
resignacionem	resignatio action de desceller	SUB
quam	quam que, combien, Ã  quel point	CON
uult	uolo2 vouloir	VBE
facere	facio faire, crÃ©er, agir	VBE
procurator	procurator administrateur, intendant, mandataire, procurateur	SUB
magistri	magister2 maÃ®tre, bourgmestre, officier seigneurial	SUB
iacobi	-	NAM
magistri	magister2 maÃ®tre, bourgmestre, officier seigneurial	SUB
canonici	canonicus2 thÃ©oricien, clerc, chanoine	SUB
diaconi	diaconus diacre	SUB
sancti	sanctus1 saint, sacrÃ©	QLF
iohannis	-	NAM
rotondi	rotondi	VBE
de	de de, du haut de, au cours de, immÃ©diatement aprÃ¨s, parmi	PRE
huiusmodi	huiusmodi de cette maniÃ¨re, de cette sorte	ADV
resigancio	resigancio	VBE
et	et et	CON
diaconatu	diaconatus diaconat, fonction de diacre	SUB
causa	causa2 cause, excuse, prÃ©texte, occasion, procÃ¨s, affaire, conflit, cas, parti, acte, chose, maladie	SUB
permutacionis	permutatio changement, permutation	SUB
fiende	fiende	VBE
cum	cum1 (+ abl.) avec	PRE
magistro	magister2 maÃ®tre, bourgmestre, officier seigneurial	SUB
nico	nico	VBE
le	le	VBE
bret	bret	VBE
presbytero	presbyter prÃªtre	SUB
cullacio	cullacio	SUB
sancti	sanctus1 saint, sacrÃ©	QLF
io	hio s'entrouvrir, prÃ©senter des hiatus, Ãªtre bÃ©at, Ã©mettre, vomir, dÃ©clamer, convoiter	VBE
.	.	SENT
ro	ro	VBE
.	.	SENT
ad	ad vers, pour, prÃ¨s de, chez, Ã , jusqu'Ã , relativement Ã , d'aprÃ¨s, par suite de	PRE
ecclesiam	ecclesia assemblÃ©e, communautÃ© de fidÃ¨les, Ã©glise	SUB
suam	suus son, sa, sien, sienne	QLF
parrochialem	parochialis diocÃ©sain, paroissial Â¶ pl. : taxes paroissiales	QLF
de	de de, du haut de, au cours de, immÃ©diatement aprÃ¨s, parmi	PRE
bonnolio	bonnolio	QLF
parisiensis	-	NAM
diocesis	diocesis diocÃ¨se, paroisse, province ecclÃ©siastique, Ã©glise paroissiale, autoritÃ© diocÃ©saine	SUB
et	et et	CON
capellaniam	capellania fonction de chapelain, chapelle royale, chapellenie	SUB
et	et et	CON
ipsum	ipse2 lui-mÃªme, elle-mÃªme	PRO
lebret	lebret	NAM
recipere	recipio recevoir, reprendre, accepter, admettre, approuver, prendre sur soi, exaucer Â¶ se r : rentrer, se ressaisir	VBE
ad	ad vers, pour, prÃ¨s de, chez, Ã , jusqu'Ã , relativement Ã , d'aprÃ¨s, par suite de	PRE
huiusmodi	huiusmodi de cette maniÃ¨re, de cette sorte	ADV
canonicatum	canonicatus canonicat	SUB
diaconatom	diaconatom	NAM
sancti	sanctus1 saint, sacrÃ©	QLF
iohannis	-	NAM
rotondi	rotondi	NAM
actenta	actenta	VBE
relacione	relatio rapport, mise en dÃ©libÃ©ration, relation, narration, charge assignÃ©e Ã  quelqu'un	SUB
facta	facio faire, crÃ©er, agir|facto faire souvent, exercer|fio se produire, se rencontrer, devenir, Ãªtre crÃ©Ã©	VBE
de	de de, du haut de, au cours de, immÃ©diatement aprÃ¨s, parmi	PRE
eius	is2 il, elle, le, la, les	PRO
sufficiente	sufficiens suffisant, content de, valable, suffisamment important	QLF
et	et et	CON
ydoneytate	ydoneytate	QLF
fiat	fio se produire, se rencontrer, devenir, Ãªtre crÃ©Ã©	VBE
mandatum	mandatum rescrit, mandement, territoire Â¶ lavement des pieds|mandatus recommandation, ordre	SUB
domino	dominus maÃ®tre, chef, seigneur, sire	SUB
succentori	succentor chanteur qui accompagne, sous-chantre, conseiller, instigateur	SUB
officiario	officiarium livre contenant les offices|officiarius officier, agent, official, membre d'une maison ecclÃ©siastique, serviteur, agent domanial, appariteur judiciaire	SUB
de	de de, du haut de, au cours de, immÃ©diatement aprÃ¨s, parmi	PRE
aue	auis oiseau|auus aÃ¯eul, aÃ¯eule	SUB
regina	regina reine, princesse, impÃ©ratrice	SUB
quod	qui2 qui, quel, lequel, quelque, quelqu'un|quot combien, aussi nombreux que, tout, chaque Â¶ tot... quot : autant... que	PRO
tradat	trado livrer, remettre, trahir, transmettre, enseigner, expliquer	VBE
domino	dominus maÃ®tre, chef, seigneur, sire	SUB
condurier	condurier	VBE
solicitatori	sollicitator sÃ©ducteur	SUB
processuum	processus progression, progrÃ¨s, procÃ¨s	SUB
ea	is2 il, elle, le, la, les	PRO
que	que (enclit.) et	CON
debentur	debeo devoir	VBE
per	per Ã  travers, par, tout le long de, durant, pendant, au cours de, par le moyen de, par suite de	PRE
tabulam	tabula planche, table, tableau, registre, contrat, bureau de change, Ã©tal, carrÃ© de terrain, pli d'un vÃªtement, mense, autel portatif, bourdon (cloche), (pl.) sortes de castagnettes	SUB
ultimo	ultimus ultime Â¶ ultima, orum, (n. pl.) les derniers moments de la vie	QLF
factam	facio faire, crÃ©er, agir|fio se produire, se rencontrer, devenir, Ãªtre crÃ©Ã©	VBE
deffunctis	deffunctis	VBE
dominis	domina dame|dominus maÃ®tre, chef, seigneur, sire	SUB
de	de de, du haut de, au cours de, immÃ©diatement aprÃ¨s, parmi	PRE
uaudetart	uaudetart	NAM
cantori	cantor chanteur, chantre	SUB
et	et et	CON
de	de de, du haut de, au cours de, immÃ©diatement aprÃ¨s, parmi	PRE
cambray	cambray	SUB
cancellario	cancellarius huissier, scribe, greffier, chancelier, notaire	SUB
placet	placeo plaire|placo apaiser	VBE
tradere	trado livrer, remettre, trahir, transmettre, enseigner, expliquer	VBE
iohanni	-	NAM
haboulle	haboulle	SUB
seniori	senior1 plus ancien, de premier rang, seigneur|senus sixiÃ¨me	QLF
commoranti	commoror s'arrÃªter, arrÃªter	VBE
apud	apud auprÃ¨s de, chez	PRE
rosay	rosay	QLF
euq	euq	VBE
piscature	piscatura mÃ©tier de pÃªcheur	SUB
quod	qui2 qui, quel, lequel, quelque, quelqu'un|quot combien, aussi nombreux que, tout, chaque Â¶ tot... quot : autant... que	PRO
domini	dominus maÃ®tre, chef, seigneur, sire	SUB
$	$	VBE
habent	habeo avoir, tenir, considÃ©rer, estimer Â¶ (+inf.) devoir, pouvoir Â¶ (impers.) il y a Â¶ (rÃ©fl.) se trouver, Ãªtre	VBE
$	$	VBE
habent	habeo avoir, tenir, considÃ©rer, estimer Â¶ (+inf.) devoir, pouvoir Â¶ (impers.) il y a Â¶ (rÃ©fl.) se trouver, Ãªtre	VBE
habent	habeo avoir, tenir, considÃ©rer, estimer Â¶ (+inf.) devoir, pouvoir Â¶ (impers.) il y a Â¶ (rÃ©fl.) se trouver, Ãªtre	VBE
in	in dans, en, sur, selon, envers, pour, contre, Ã  propos de, vu, par, avec	PRE
eorum	is2 il, elle, le, la, les	PRO
dominio	dominium propriÃ©tÃ©, pouvoir, rÃ©serve seigneuriale	SUB
de	de de, du haut de, au cours de, immÃ©diatement aprÃ¨s, parmi	PRE
$	$	QLF
rosy	rosy	VBE
$	$	VBE
rosayo	rosayo	QLF
et	et et	CON
uoille	uoille	SUB
in	in dans, en, sur, selon, envers, pour, contre, Ã  propos de, vu, par, avec	PRE
riparia	riparius1 qui se tient sur les rives	QLF
de	de de, du haut de, au cours de, immÃ©diatement aprÃ¨s, parmi	PRE
edera	hedera lierre	SUB
pro	pro devant, en avant de, pour, en faveur de, Ã  la place de, en raison de	PRE
uiii	8	NUM
s	signum anneau sigillaire, sceau, seing manuel, monogramme, borne, marque, signe, symbole, signal, cloche, prodige, miracle	SUB
.	.	SENT
p	-	NAM
.	.	SENT
usque	usque sans cesse, jusque, depuis	ADV
ad	ad vers, pour, prÃ¨s de, chez, Ã , jusqu'Ã , relativement Ã , d'aprÃ¨s, par suite de	PRE
sex	sex six	NUM
annos	annus annÃ©e, saison	SUB
proximos	propinquus1 proche, prochain, parent, apparentÃ©, voisin	QLF
uenturos	uenio venir, arriver	VBE
modo	modo2 dans cette mesure, seulement, Ã  l'instant, tout de suite, rÃ©cemment, maintenant	ADV
et	et et	CON
forma	forma forme, type, beautÃ©, moule	SUB
in	in dans, en, sur, selon, envers, pour, contre, Ã  propos de, vu, par, avec	PRE
i	1	NUM
breueto	breueto	VBE
castellet	castello1 construire (ou habiter) un ouvrage fortifiÃ©, prÃ©poser Ã  la garde d'un chÃ¢teau	VBE
signato	signatus1 marquÃ©, scellÃ©, croisÃ©	QLF
$	$	VBE
e	ex hors de, Ã  partir de, aprÃ¨s, en (matiÃ¨re), selon	PRE
$	$	QLF
e	ex hors de, Ã  partir de, aprÃ¨s, en (matiÃ¨re), selon	PRE
.	.	SENT
perrot	perrot	VBE
et	et et	CON
i	1	NUM
.	.	SENT
andry	andry	SUB
de	de de, du haut de, au cours de, immÃ©diatement aprÃ¨s, parmi	PRE
data	do donner, concÃ©der, lÃ©guer, exprimer	VBE
diei	dies jour, dÃ©lai, climat, jour de fÃªte, anniversaire, journÃ©e de travail, journal (de terre)	SUB
presentis	presens prÃ©sent, visible, efficace, secourable, favorable, de sang froid, rÃ©solu	QLF
data	do donner, concÃ©der, lÃ©guer, exprimer	VBE
est	sum Ãªtre, exister, signifier Â¶ est : il est possible, il s'agit de	VBE
facultas	facultas facultÃ©, talent, abondance, essence, patrimoine, moyens (financiers)|falcata fauchÃ©e (Ã©tendue de prairie qu'on peut faucher en une journÃ©e.)	SUB
cardino	gardinus jardin	SUB
chanpion	chanpion	SUB
de	de de, du haut de, au cours de, immÃ©diatement aprÃ¨s, parmi	PRE
bosco	boscus bosquet, petit bois	SUB
artisii	artisii	SUB
redimendi	redimo racheter, prendre Ã  ferme, Ãªtre adjudicataire, affranchir	VBE
infra	infra2 en dessous de, en bas de, moins de, Ã  l'intÃ©rieur de, pendant, en moins de	PRE
sex	sex six	NUM
annos	annus annÃ©e, saison	SUB
a	a (+ abl.) Ã  partir de, loin de, du cÃ´tÃ© de, par suite de, par	PRE
uiia	uiia	QLF
februari	februo purifier	VBE
proxima	propinquus1 proche, prochain, parent, apparentÃ©, voisin	QLF
ueniente	uenio venir, arriver	VBE
computandos	computo calculer, compter	VBE
annuum	annuum revenu annuel	SUB
redditum	redditus1 frÃ¨re convers|redditus2 remise, don, redevance|reditus retour, retraite, revenu, rÃ©volution (astre)	SUB
xl	40	NUM
t	-	NAM
.	.	SENT
alias	alius autre	QLF
per	per Ã  travers, par, tout le long de, durant, pendant, au cours de, par le moyen de, par suite de	PRE
eum	is2 il, elle, le, la, les	PRO
constitutum	constituo Ã©tablir, organiser, se trouver	VBE
ecclesie	ecclesia assemblÃ©e, communautÃ© de fidÃ¨les, Ã©glise	SUB
etc	etc	VBE
lune	luna lune, mois, gorge, lunule	SUB
xxxa	xxxa	NUM
ianuarii	ianuarius2 janvier Â¶ portier	SUB
anno	annus annÃ©e, saison	SUB
nona_	nona_	VBE
ui_	ui_	VBE
ordinarie	ordinarius2 chanoine, ordinaire (chargÃ© d'une juridiction ecclÃ©siastique ou d'une fonction rÃ©guliÃ¨re)	SUB
capitulantibus	capitulo Ã©numÃ©rer, stipuler, rÃ©unir le chapitre, chapitrer	VBE
dominis	domina dame|dominus maÃ®tre, chef, seigneur, sire	SUB
decano	decanus dizenier ou doyen, personne placÃ©e Ã  la tÃªte de dix autres, supÃ©rieur	SUB
condurier	condurier	VBE
iuuenel	iuuenel	NAM
cantore	cantor chanteur, chantre	SUB
damet	damet	VBE
fournier	fournier	VBE
archidiacono	archidiaconus archidiacre	SUB
par	par1 Ã©gal, pareil, appariÃ©	QLF
.	.	SENT
lailly	lailly	NAM
cancellario	cancellarius huissier, scribe, greffier, chancelier, notaire	SUB
saulay	saulay	NAM
domulle	domulle	SUB
penitenciario	penitenciario	QLF
bellay	bellay	VBE
laubespine	laubespine	NAM
louuiers	louuiers	NAM
refuge	refugus fuyard, fugitif, qui Ã©chappe, apostat Â¶ refugi fluctus, (m. pl.) le reflux	QLF
dumoulin	dumoulin	SUB
picart	picart	NAM
fabry	fabry	SUB
cerisay	cerisay	SUB
michel	-	NAM
samxon	samxon	NAM
parpas	parpas	VBE
gaignon	gaignon	SUB
lenffant	lenffant	VBE
aymery	aymery	SUB
chasteaupers	chasteaupers	QLF
prepositi	prepono placer devant, donner le commandement Ã	VBE
