form	lemma	POS morph
sequitur	sequor suivre, poursuivre, succÃ©der, s'ensuivre, obÃ©ir, Ã©choir	VBE
tenor	tenor continuitÃ©, maintien, ton, teneur, registre	SUB
lictere	lictere	SUB
presentacionis	presentatio prÃ©sentation, collation, cadeau	SUB
m	1000	NUM
.	.	SENT
io	io ah ! oh ! las !	INT
.	.	SENT
melleti	melletus tissu mÃ©langÃ©	SUB
ad	ad vers, pour, prÃ¨s de, chez, Ã , jusqu'Ã , relativement Ã , d'aprÃ¨s, par suite de	PRE
magnam	magnus grand, magnanime, emphatique	QLF
uicariam	uicaria remplaÃ§ante, rechange Â¶ viguerie, vicairie	SUB
ecclesie	ecclesia assemblÃ©e, communautÃ© de fidÃ¨les, Ã©glise	SUB
par	par1 Ã©gal, pareil, appariÃ©	QLF
.	.	SENT
uenerabilibus	uenerabilis vÃ©nÃ©rable, respectueux	QLF
circunspectis	circunspectis	VBE
uiris	uir homme, mari|uira femme|uirus suc, humeur, bave, poison, puanteur	SUB
dominis	domina dame|dominus maÃ®tre, chef, seigneur, sire	SUB
decano	decanus dizenier ou doyen, personne placÃ©e Ã  la tÃªte de dix autres, supÃ©rieur	SUB
et	et et	CON
capitulo	capitulum petite tÃªte, tÃªte, capuchon, coiffure, chapiteau, chapitre, chevet	SUB
ecclesie	ecclesia assemblÃ©e, communautÃ© de fidÃ¨les, Ã©glise	SUB
par	par1 Ã©gal, pareil, appariÃ©	QLF
.	.	SENT
decanus	decanus dizenier ou doyen, personne placÃ©e Ã  la tÃªte de dix autres, supÃ©rieur	SUB
et	et et	CON
capitulum	capitulum petite tÃªte, tÃªte, capuchon, coiffure, chapiteau, chapitre, chevet	SUB
ecclesie	ecclesia assemblÃ©e, communautÃ© de fidÃ¨les, Ã©glise	SUB
collegiate	collegiatus1 d'une association, collÃ©gial	QLF
sancti	sanctus1 saint, sacrÃ©	QLF
marcelli	martellus petit marteau	SUB
prope	prope2 prÃ¨s de	PRE
par	par1 Ã©gal, pareil, appariÃ©	QLF
.	.	SENT
reuerenciam	reuerentia crainte, respect, dÃ©fÃ©rence	SUB
cum	cum1 (+ abl.) avec	PRE
honore	honor honneur, charge	SUB
ad	ad vers, pour, prÃ¨s de, chez, Ã , jusqu'Ã , relativement Ã , d'aprÃ¨s, par suite de	PRE
uicariam	uicaria remplaÃ§ante, rechange Â¶ viguerie, vicairie	SUB
perpetuam	perpetuus continu, perpÃ©tuel	QLF
uostre	uester votre, vÃ´tre	QLF
ecclesie	ecclesia assemblÃ©e, communautÃ© de fidÃ¨les, Ã©glise	SUB
que	que (enclit.) et	CON
sancti	sanctus1 saint, sacrÃ©	QLF
marcelli	martellus petit marteau	SUB
extra	extra2 au-dehors de, en plus de, exceptÃ©, sans	PRE
parisius	-	NAM
uulgariter	uulgariter communÃ©ment	ADV
nuncupatur	nuncupo appeler	VBE
ad	ad vers, pour, prÃ¨s de, chez, Ã , jusqu'Ã , relativement Ã , d'aprÃ¨s, par suite de	PRE
presens	presens prÃ©sent, visible, efficace, secourable, favorable, de sang froid, rÃ©solu	QLF
liberam	liber2 de condition libre, affranchi (de) vacant, libre (de)	QLF
et	et et	CON
uacantem	uaco s'appliquer Ã , vaquer Ã , Ãªtre vacant	VBE
per	per Ã  travers, par, tout le long de, durant, pendant, au cours de, par le moyen de, par suite de	PRE
mortem	mors mort	SUB
magistri	magister2 maÃ®tre, bourgmestre, officier seigneurial	SUB
nicolay	nicolay	SUB
sellarii	sellaris2 cheval de selle|sellarium selle|sellarius sellier	SUB
ultimi	ultimus ultime Â¶ ultima, orum, (n. pl.) les derniers moments de la vie	QLF
possessoris	possessor possesseur, propriÃ©taire	SUB
eiusdem	idem1 (le) mÃªme, ledit, ce	QLF
ad	ad vers, pour, prÃ¨s de, chez, Ã , jusqu'Ã , relativement Ã , d'aprÃ¨s, par suite de	PRE
presentacionem	presentatio prÃ©sentation, collation, cadeau	SUB
nostram	noster notre, le nÃ´tre	QLF
et	et et	CON
uestram	uester votre, vÃ´tre	QLF
collacionem	collatio assemblage, rÃ©union, confrontation, contribution, don, comparaison, rapprochement, collation	SUB
ab	a (+ abl.) Ã  partir de, loin de, du cÃ´tÃ© de, par suite de, par	PRE
antiquo	antiquus antique, ancien	QLF
spectantem	specto regarder, considÃ©rer, examiner, Ã©prouver, avoir en vue, donner sur	VBE
et	et et	CON
pertinentem	pertineo s'Ã©tendre jusqu'Ã , relever de, succÃ©der Ã	VBE
/	/	VBE
dilectum	delectus choix, discernement, levÃ©e de troupes, recrues|dilectus2 affection, amour, dÃ©sir, soin	SUB
fratrem	frater frÃ¨re	SUB
et	et et	CON
concanonicum	concanonicus cochanoine	SUB
nostrum	noster notre, le nÃ´tre	QLF
uenerabilem	uenerabilis vÃ©nÃ©rable, respectueux	QLF
et	et et	CON
discretum	discerno sÃ©parer, choisir, juger|discresco croÃ®tre beaucoup	VBE
uirum	uir homme, mari|uirus suc, humeur, bave, poison, puanteur	SUB
magistrum	magister2 maÃ®tre, bourgmestre, officier seigneurial	SUB
iohannem	-	NAM
melleti	melletus tissu mÃ©langÃ©	SUB
presbyterum	presbyter prÃªtre	SUB
in	in dans, en, sur, selon, envers, pour, contre, Ã  propos de, vu, par, avec	PRE
iure	ius droit, justice Â¶ jus, sauce	SUB
ciuili	ciuilis1 civil, politique, affable	QLF
licenciato	licentio permettre, congÃ©dier	VBE
tamquam	tamquam comme, de mÃªme que, en qualitÃ© de, pour ainsi dire	CON
sufficientes	sufficio fournir, suffire, Ãªtre capable de	VBE
habilem	habilis maniable, propre Ã , agile	QLF
/	/	VBE
et	et et	CON
ydoneum	idoneus appropriÃ© Â¶ disculpÃ©, innocent, capable d'ester, authentique	QLF
ad	ad vers, pour, prÃ¨s de, chez, Ã , jusqu'Ã , relativement Ã , d'aprÃ¨s, par suite de	PRE
huiusmodi	huiusmodi de cette maniÃ¨re, de cette sorte	ADV
uicariam	uicaria remplaÃ§ante, rechange Â¶ viguerie, vicairie	SUB
obtinendum	obtineo obtenir, tenir solidement, garder, maintenir (ou Ã©tablir) une opinion, rÃ©ussir, durer	VBE
uobis	uos vous	PRO
presencium	presens prÃ©sent, visible, efficace, secourable, favorable, de sang froid, rÃ©solu	QLF
tenore	tenor continuitÃ©, maintien, ton, teneur, registre	SUB
presentamus	presento prÃ©senter	VBE
uos	uos vous	PRO
rogantes	rogo demander, interroger, solliciter, rÃ©clamer	VBE
et	et et	CON
requirentes	requiro rechercher, rÃ©clamer, ne pas trouver, regretter, percevoir	VBE
quatinus	quatenus jusqu'Ã  quel point, dans la mesure oÃ¹, en tant que, puisque, afin que, que	CON
prefato	prefatus susdit	QLF
magistro	magister2 maÃ®tre, bourgmestre, officier seigneurial	SUB
iohanni	-	NAM
melleti	melletus tissu mÃ©langÃ©	SUB
concanonico	concanonicus cochanoine	SUB
et	et et	CON
presentato	presento prÃ©senter	VBE
nostro	noster notre, le nÃ´tre	QLF
dictam	dictus dit, susdit	QLF
uicariam	uicaria remplaÃ§ante, rechange Â¶ viguerie, vicairie	SUB
sic	sic ainsi, voici, de mÃªme, Ã  ce point	ADV
uacantem	uaco s'appliquer Ã , vaquer Ã , Ãªtre vacant	VBE
cum	cum1 (+ abl.) avec	PRE
suis	suus son, sa, sien, sienne	QLF
iuribus	ius droit, justice Â¶ jus, sauce	SUB
et	et et	CON
pertinenciis	pertinentia dÃ©pendance, domaine	SUB
uniuersis	uniuersus tout entier Â¶ (plur.) tous sans exception	QLF
conferre	confero apporter, confÃ©rer	VBE
sibique	sibique	ADV
de	de de, du haut de, au cours de, immÃ©diatement aprÃ¨s, parmi	PRE
eadem	idem1 (le) mÃªme, ledit, ce	QLF
prouidere	prouideo prÃ©voir, pourvoir, prÃ©parer, veiller sur	VBE
uelitis	uolo2 vouloir	VBE
.	.	SENT
ceteraque	ceteraque	QLF
facere	facio faire, crÃ©er, agir	VBE
que	que (enclit.) et	CON
in	in dans, en, sur, selon, envers, pour, contre, Ã  propos de, vu, par, avec	PRE
hac	hic2 ce, cet	QLF
parte	pars part, partie, partage, parti Â¶ (pl.) rÃ´le (d'un acteur), parti|parta qui a enfantÃ©	SUB
incumbunt	incumbo s'Ã©tendre, s'appuyer sur, se pencher, peser sur, s'appliquer Ã , incomber, appartenir, Ãªtre dÃ», habiter	VBE
et	et et	CON
fuerint	sum Ãªtre, exister, signifier Â¶ est : il est possible, il s'agit de	VBE
facienda	facio faire, crÃ©er, agir	VBE
in	in dans, en, sur, selon, envers, pour, contre, Ã  propos de, vu, par, avec	PRE
cuius	qui2 qui, quel, lequel, quelque, quelqu'un|quis qui, que, quelqu'un, quelque	PRO
rei	res chose, cause, affaire, Ã©vÃ©nement, bien, fortune, intÃ©rÃªt, litige, faits Â¶ (indÃ©cl.) res (lettre hÃ©br.)|reus2 accusÃ©, prÃ©venu, dÃ©biteur, condamnÃ©, coupable	SUB
testimonium	testimonium tÃ©moignage, preuve, prÃ©cepte, tÃ©moin, rÃ©putation	SUB
sigillum	sigillum figurine, sceau, lettre scellÃ©e, seing manuel Â¶ sigle	SUB
nostrum	noster notre, le nÃ´tre	QLF
capitulare	capitularis1 divisÃ© en chapitres, marquant le dÃ©but d'un chapitre, membre d'un chapitre de religieux	QLF
presentibus	presens prÃ©sent, visible, efficace, secourable, favorable, de sang froid, rÃ©solu	QLF
licteris	licteris	QLF
duximus	duco tirer, conduire, transporter, compter	VBE
apponendum	appono placer, mettre en gage	VBE
datum	do donner, concÃ©der, lÃ©guer, exprimer	VBE
in	in dans, en, sur, selon, envers, pour, contre, Ã  propos de, vu, par, avec	PRE
capitulo	capitulum petite tÃªte, tÃªte, capuchon, coiffure, chapiteau, chapitre, chevet	SUB
nostro	noster notre, le nÃ´tre	QLF
anno	annus annÃ©e, saison	SUB
domini	dominus maÃ®tre, chef, seigneur, sire	SUB
m_	m_	QLF
cccc_	cccc_	NUM
xxx	30	NUM
ui_	ui_	VBE
die	dies jour, dÃ©lai, climat, jour de fÃªte, anniversaire, journÃ©e de travail, journal (de terre)	SUB
ueneris	uenus VÃ©nus, amour, charme, mai Â¶ vente	SUB
xxuia	xxuia	NUM
mensis	mensa table, mense|mensis mois|mensum mesure (de terre)	SUB
octobris	october mois d'octobre	SUB
sic	sic ainsi, voici, de mÃªme, Ã  ce point	ADV
signatum	signo marquer, sceller, prouver, signaler, observer, souscrire, symboliser	VBE
merati	merati	SUB
conceditur	concedo s'en aller Â¶ accorder, concÃ©der	VBE
de	de de, du haut de, au cours de, immÃ©diatement aprÃ¨s, parmi	PRE
gracia	gratia2 faveur, gratitude, grÃ¢ce	SUB
speciali	specialis1 intime, particulier, privÃ©, confidentiel	QLF
contemplacione	contemplatio contemplation, considÃ©ration  Â¶ contemplatione + gÃ©n. : eu Ã©gard Ã	SUB
magistri	magister2 maÃ®tre, bourgmestre, officier seigneurial	SUB
iohannis	-	NAM
d'estampis	d'estampis	SUB
cantoris	cantor chanteur, chantre	SUB
et	et et	CON
canonici	canonicus2 thÃ©oricien, clerc, chanoine	SUB
ecclesie	ecclesia assemblÃ©e, communautÃ© de fidÃ¨les, Ã©glise	SUB
pari	par1 Ã©gal, pareil, appariÃ©	QLF
.	.	SENT
ac	atque et	CON
domini	dominus maÃ®tre, chef, seigneur, sire	SUB
nostri	noster notre, le nÃ´tre	QLF
pape	papa pÃ¨re, Ã©vÃªque, pape	SUB
familiaris	familiaris1 de la maison, de la domesticitÃ©, familier	QLF
licencia	licentia libertÃ©, congÃ©, dispense d'obligations de la rÃ¨gle monastique, libertÃ© sans contrÃ´le, licence, dÃ©bordement, puissance, possibilitÃ©	SUB
data	do donner, concÃ©der, lÃ©guer, exprimer	VBE
domino	dominus maÃ®tre, chef, seigneur, sire	SUB
ro	ro	VBE
.	.	SENT
de	de de, du haut de, au cours de, immÃ©diatement aprÃ¨s, parmi	PRE
necnon	necnon et aussi, et	CON
pluribus	plus2 une plus grande quantitÃ©	SUB
aliis	alius autre	QLF
de	de de, du haut de, au cours de, immÃ©diatement aprÃ¨s, parmi	PRE
causis	causa2 cause, excuse, prÃ©texte, occasion, procÃ¨s, affaire, conflit, cas, parti, acte, chose, maladie|causos fiÃ¨vre, chaleur sÃ¨che	SUB
consideratis	consedeo Ãªtre assis avec (ensemble), s'asseoir, occuper|considero considÃ©rer, mÃ©diter|consido siÃ©ger, s'Ã©tablir	VBE
/	/	VBE
domino	dominus maÃ®tre, chef, seigneur, sire	SUB
roberto	-	NAM
d'estampis	d'estampis	SUB
militi	miles soldat, chevalier, vassal	SUB
fratri	frater frÃ¨re	SUB
dicti	dictus dit, susdit	QLF
domini	dominus maÃ®tre, chef, seigneur, sire	SUB
cantoris	cantor chanteur, chantre	SUB
ex	ex hors de, Ã  partir de, aprÃ¨s, en (matiÃ¨re), selon	PRE
parte	pars part, partie, partage, parti Â¶ (pl.) rÃ´le (d'un acteur), parti|parta qui a enfantÃ©	SUB
cuius	qui2 qui, quel, lequel, quelque, quelqu'un|quis qui, que, quelqu'un, quelque	PRO
fuit	sum Ãªtre, exister, signifier Â¶ est : il est possible, il s'agit de	VBE
stampis	-	NAM
manendi	maneo demeurer, rester	VBE
in	in dans, en, sur, selon, envers, pour, contre, Ã  propos de, vu, par, avec	PRE
claustro	claustrum bÃ¢timent monastique ou canonial, cloÃ®tre, monastÃ¨re, enceinte, col, frontiÃ¨re	SUB
super	super sur, au-dessus (de), prÃ¨s de, au sujet de, envers, contre, en plus de, plus que, Ã  cause de, pendant, sur, sous peine de, au risque de	PRE
hoc	hic3 celui-ci, celle-ci	PRO
capitulo	capitulum petite tÃªte, tÃªte, capuchon, coiffure, chapiteau, chapitre, chevet	SUB
supplicatum	supplicatus supplication	SUB
quod	qui2 qui, quel, lequel, quelque, quelqu'un|quot combien, aussi nombreux que, tout, chaque Â¶ tot... quot : autant... que	PRO
ipse	ipse2 lui-mÃªme, elle-mÃªme	PRO
miles	miles soldat, chevalier, vassal	SUB
hinc	hinc de lÃ , de cet endroit, de cela, Ã  ce sujet	ADV
ad	ad vers, pour, prÃ¨s de, chez, Ã , jusqu'Ã , relativement Ã , d'aprÃ¨s, par suite de	PRE
annum	annus annÃ©e, saison	SUB
dumtaxat	dumtaxat (jusque-lÃ ) seulement, pas plus que, du moins, Ã  savoir, surtout	ADV
possit	possum pouvoir Â¶ non p. facere quin, non p. quin : je ne peux pas empÃªcher que	VBE
habitare	habito rÃ©sider, occuper, s'attarder	VBE
et	et et	CON
manere	maneo demeurer, rester	VBE
in	in dans, en, sur, selon, envers, pour, contre, Ã  propos de, vu, par, avec	PRE
domo	domus maison, dynastie, manse	SUB
claustrali	claustralis1 qui ferme, claustral, monastique, canonial	QLF
m	1000	NUM
.	.	SENT
in	in dans, en, sur, selon, envers, pour, contre, Ã  propos de, vu, par, avec	PRE
domo	domus maison, dynastie, manse	SUB
m	1000	NUM
.	.	SENT
q	-	NAM
.	.	SENT
menart	menart	NAM
quintini	-	NAM
menart	menart	NAM
canonici	canonicus2 thÃ©oricien, clerc, chanoine	SUB
par	par1 Ã©gal, pareil, appariÃ©	QLF
.	.	SENT
dum	dum (indic.) pendant que, aussi longtemps que, jusqu'au moment oÃ¹, (subj.) jusqu'Ã  ce que, pourvu que, comme, alors que	CON
tamen	tamen cependant, toutefois	CON
habeatur	habeo avoir, tenir, considÃ©rer, estimer Â¶ (+inf.) devoir, pouvoir Â¶ (impers.) il y a Â¶ (rÃ©fl.) se trouver, Ãªtre	VBE
concensum	concensus cens	SUB
dicti	dictus dit, susdit	QLF
menart	menart	NAM
/	/	VBE
aut	aut ou bien	CON
suorum	suus son, sa, sien, sienne	QLF
procuratorum	procuro s'occuper de qqch Ã  la place de qqn, fournir, entretenir	VBE
.	.	SENT
quia	quia parce que, de ce que, que	CON
ex	ex hors de, Ã  partir de, aprÃ¨s, en (matiÃ¨re), selon	PRE
parte	pars part, partie, partage, parti Â¶ (pl.) rÃ´le (d'un acteur), parti|parta qui a enfantÃ©	SUB
domine	domina dame|dominus maÃ®tre, chef, seigneur, sire	SUB
de	de de, du haut de, au cours de, immÃ©diatement aprÃ¨s, parmi	PRE
poyssi	poyssi	SUB
et	et et	CON
nonullorum	nonullorum	SUB
aliorum	alius autre	QLF
requirebatur	requiro rechercher, rÃ©clamer, ne pas trouver, regretter, percevoir	VBE
quod	qui2 qui, quel, lequel, quelque, quelqu'un|quot combien, aussi nombreux que, tout, chaque Â¶ tot... quot : autant... que	PRO
quidem	quidem certes, assurÃ©ment, mais du moins, en tout cas, quant Ã  Â¶ ne... quidem : ne pas mÃªme, non plus	ADV
nicolaus	nicolaus variÃ©tÃ© de datte	SUB
sanisart	sanisart	QLF
institueretur	instituo installer, instituer, statuer, promulguer, enseigner	VBE
per	per Ã  travers, par, tout le long de, durant, pendant, au cours de, par le moyen de, par suite de	PRE
capitulum	capitulum petite tÃªte, tÃªte, capuchon, coiffure, chapiteau, chapitre, chevet	SUB
prepositus	prepositus prÃ©vÃ´t, prieur, commandant	SUB
de	de de, du haut de, au cours de, immÃ©diatement aprÃ¨s, parmi	PRE
preposito	prepositus prÃ©vÃ´t, prieur, commandant	SUB
de	de de, du haut de, au cours de, immÃ©diatement aprÃ¨s, parmi	PRE
andresi	andresi	QLF
apud	apud auprÃ¨s de, chez	PRE
andresiacum	andresiacum	NAM
pro	pro devant, en avant de, pour, en faveur de, Ã  la place de, en raison de	PRE
dominis	domina dame|dominus maÃ®tre, chef, seigneur, sire	SUB
de	de de, du haut de, au cours de, immÃ©diatement aprÃ¨s, parmi	PRE
capitulo	capitulum petite tÃªte, tÃªte, capuchon, coiffure, chapiteau, chapitre, chevet	SUB
par	par1 Ã©gal, pareil, appariÃ©	QLF
.	.	SENT
loco	locus lieu, place, passage (d'un Ã©crit), localitÃ©, monastÃ¨re	SUB
alterius	alter autre (de deux), autrui	QLF
prepositi	prepositus prÃ©vÃ´t, prieur, commandant	SUB
ibidem	ibidem lÃ  mÃªme, au mÃªme moment	ADV
ordinatum	ordino ordonner, administrer, rÃ©gler, lÃ©guer	VBE
est	sum Ãªtre, exister, signifier Â¶ est : il est possible, il s'agit de	VBE
quod	qui2 qui, quel, lequel, quelque, quelqu'un|quot combien, aussi nombreux que, tout, chaque Â¶ tot... quot : autant... que	PRO
huiusmodi	huiusmodi de cette maniÃ¨re, de cette sorte	ADV
negocium	negotium affaire, occupation, travail, chose, marchandise, marchÃ©, activitÃ© politique, litige	SUB
teneatur	teneo (se) tenir, atteindre, s'arrÃªter, occuper, contenir, garder, dÃ©tenir, arrÃªter, empÃªcher, comprendre, savoir, croire, affirmer Â¶ (pass.) Ãªtre pris, Ãªtre convaincu d'un crime, Ãªtre tenu de	VBE
in	in dans, en, sur, selon, envers, pour, contre, Ã  propos de, vu, par, avec	PRE
suspenso	suspensus1 suspendu	QLF
et	et et	CON
quod	qui2 qui, quel, lequel, quelque, quelqu'un|quot combien, aussi nombreux que, tout, chaque Â¶ tot... quot : autant... que	PRO
interim	interim cependant, en attendant, momentanÃ©ment, parfois	ADV
fiat	fio se produire, se rencontrer, devenir, Ãªtre crÃ©Ã©	VBE
informacio	informatio dessin, esquisse, idÃ©e, explication de mot, enseignement, exhortation	SUB
de	de de, du haut de, au cours de, immÃ©diatement aprÃ¨s, parmi	PRE
persona	persona masque, rÃ´le, personnage, personne, personnalitÃ©, curÃ©	SUB
dicti	dictus dit, susdit	QLF
nicolai	nicolaus variÃ©tÃ© de datte	SUB
et	et et	CON
postmodum	postmodo bientÃ´t aprÃ¨s, par la suite	ADV
super	super sur, au-dessus (de), prÃ¨s de, au sujet de, envers, contre, en plus de, plus que, Ã  cause de, pendant, sur, sous peine de, au risque de	PRE
hoc	hic3 celui-ci, celle-ci	PRO
prouidebitur	prouideo prÃ©voir, pourvoir, prÃ©parer, veiller sur	VBE
.	.	SENT
quia	quia parce que, de ce que, que	CON
iohannes	-	NAM
symon	-	NAM
custos	custos gardien, coutre (sacristain), ecclÃ©siastique chargÃ© d'un service dÃ©terminÃ© Â¶ courson|custus coÃ»t	SUB
pauperum	pauper pauvre	QLF
puerorum	puer enfant, fils, esclave, serviteur, vassal	SUB
repertorum	reperta dÃ©couvertes, inventions|repertor inventeur, auteur	SUB
in	in dans, en, sur, selon, envers, pour, contre, Ã  propos de, vu, par, avec	PRE
ecclesia	ecclesia assemblÃ©e, communautÃ© de fidÃ¨les, Ã©glise	SUB
par	par1 Ã©gal, pareil, appariÃ©	QLF
.	.	SENT
supplicauit	supplico supplier, prier, s'incliner pour saluer, adresser des priÃ¨res	VBE
dominis	domina dame|dominus maÃ®tre, chef, seigneur, sire	SUB
capitulantibus	capitulo Ã©numÃ©rer, stipuler, rÃ©unir le chapitre, chapitrer	VBE
ut	ut comment, comme, combien Â¶ (+ indic.) : de mÃªme que, quand, vu que Â¶ (+ subj.) : que, Ã  savoir que, pour que, de sorte que, tellement que, si bien que, Ã  supposer que Â¶ (+ part. futur) : avec l'intention de, comme pour	CON
sibi	se se, soi	PRO
uellent	uello arracher, tirer|uolo2 vouloir	VBE
concedere	concedo s'en aller Â¶ accorder, concÃ©der	VBE
quod	qui2 qui, quel, lequel, quelque, quelqu'un|quot combien, aussi nombreux que, tout, chaque Â¶ tot... quot : autant... que	PRO
ipse	ipse2 lui-mÃªme, elle-mÃªme	PRO
posset	possum pouvoir Â¶ non p. facere quin, non p. quin : je ne peux pas empÃªcher que	VBE
recipere	recipio recevoir, reprendre, accepter, admettre, approuver, prendre sur soi, exaucer Â¶ se r : rentrer, se ressaisir	VBE
et	et et	CON
habere	habeo avoir, tenir, considÃ©rer, estimer Â¶ (+inf.) devoir, pouvoir Â¶ (impers.) il y a Â¶ (rÃ©fl.) se trouver, Ãªtre	VBE
legata	legata ambassadrice|legatum legs	SUB
facta	facio faire, crÃ©er, agir|facto faire souvent, exercer|fio se produire, se rencontrer, devenir, Ãªtre crÃ©Ã©	VBE
et	et et	CON
facienda	facio faire, crÃ©er, agir	VBE
dictis	dictus dit, susdit	QLF
pueris	puer enfant, fils, esclave, serviteur, vassal|puera enfant, fillette	SUB
in	in dans, en, sur, selon, envers, pour, contre, Ã  propos de, vu, par, avec	PRE
testamentis	testamentum attestation, testament, pacte, promesse  Â¶ tables de la loi, nouveau ou ancien Testament	SUB
decedencium	decedo s'Ã©loigner de, disparaÃ®tre, renoncer Ã	VBE
ultra	ultra2 au-delÃ  de, outre	PRE
iiiior	quattuor quatre	NUM
solidos	solidus2 sou Â¶ (pl.) solde	SUB
par	par1 Ã©gal, pareil, appariÃ©	QLF
.	.	SENT
quos	qui2 qui, quel, lequel, quelque, quelqu'un|quis qui, que, quelqu'un, quelque	PRO
officiarius	officiarius officier, agent, official, membre d'une maison ecclÃ©siastique, serviteur, agent domanial, appariteur judiciaire	SUB
mandeti	mandeti	VBE
sibi	se se, soi	PRO
tradit	trado livrer, remettre, trahir, transmettre, enseigner, expliquer	VBE
et	et et	CON
soluit	soluo dÃ©lier, dÃ©livrer, acquitter, payer, rompre, relÃ¢cher, anÃ©antir, se dÃ©sister, renoncer Ã	VBE
pro	pro devant, en avant de, pour, en faveur de, Ã  la place de, en raison de	PRE
qualibet	quilibet2 n'importe lequel, celui qu'on voudra, chacun	PRO
ebdomada	hebdomas le nombre sept, sept jours, sept ans, septÃ©naire, semaine	SUB
.	.	SENT
ordinatum	ordino ordonner, administrer, rÃ©gler, lÃ©guer	VBE
est	sum Ãªtre, exister, signifier Â¶ est : il est possible, il s'agit de	VBE
quod	qui2 qui, quel, lequel, quelque, quelqu'un|quot combien, aussi nombreux que, tout, chaque Â¶ tot... quot : autant... que	PRO
nichil	nihil rien, le nÃ©ant Â¶ pas du tout	SUB
habebit	habeo avoir, tenir, considÃ©rer, estimer Â¶ (+inf.) devoir, pouvoir Â¶ (impers.) il y a Â¶ (rÃ©fl.) se trouver, Ãªtre	VBE
de	de de, du haut de, au cours de, immÃ©diatement aprÃ¨s, parmi	PRE
dictis	dictus dit, susdit	QLF
legatis	legata ambassadrice|legatum legs|legatus lÃ©gat, ambassadeur	SUB
sed	sed mais	CON
habebit	habeo avoir, tenir, considÃ©rer, estimer Â¶ (+inf.) devoir, pouvoir Â¶ (impers.) il y a Â¶ (rÃ©fl.) se trouver, Ãªtre	VBE
per	per Ã  travers, par, tout le long de, durant, pendant, au cours de, par le moyen de, par suite de	PRE
manum	manus2 main, force, troupe, pouvoir, coup au jeu	SUB
dicti	dictus dit, susdit	QLF
officiarii	officiarium livre contenant les offices|officiarius officier, agent, official, membre d'une maison ecclÃ©siastique, serviteur, agent domanial, appariteur judiciaire	SUB
de	de de, du haut de, au cours de, immÃ©diatement aprÃ¨s, parmi	PRE
cetero	ceterus le reste de	QLF
pro	pro devant, en avant de, pour, en faveur de, Ã  la place de, en raison de	PRE
qualibet	quilibet2 n'importe lequel, celui qu'on voudra, chacun	PRO
ebdomada	hebdomas le nombre sept, sept jours, sept ans, septÃ©naire, semaine	SUB
pro	pro devant, en avant de, pour, en faveur de, Ã  la place de, en raison de	PRE
dictis	dictus dit, susdit	QLF
pueris	puer enfant, fils, esclave, serviteur, vassal|puera enfant, fillette	SUB
prout	prout selon que, dans la mesure oÃ¹, comme	CON
alias	alius autre	QLF
solebat	soleo avoir coutume	VBE
habere	habeo avoir, tenir, considÃ©rer, estimer Â¶ (+inf.) devoir, pouvoir Â¶ (impers.) il y a Â¶ (rÃ©fl.) se trouver, Ãªtre	VBE
uidelicet	uidelicet il va de soi, bien sÃ»r, sans doute, apparemment  Â¶ c'est-Ã -dire	ADV
duos	duo deux	NUM
solidos	solidus2 sou Â¶ (pl.) solde	SUB
ultra	ultra2 au-delÃ  de, outre	PRE
dictos	dictus dit, susdit	QLF
iiiior	quattuor quatre	NUM
solidos	solidus2 sou Â¶ (pl.) solde	SUB
.	.	SENT
mercurii	mercurius garrot d'un animal	SUB
xxuiii	28	NUM
nouembris	nouember novembre	SUB
capitulantibus	capitulo Ã©numÃ©rer, stipuler, rÃ©unir le chapitre, chapitrer	VBE
dominis	domina dame|dominus maÃ®tre, chef, seigneur, sire	SUB
.	.	SENT
decano	decanus dizenier ou doyen, personne placÃ©e Ã  la tÃªte de dix autres, supÃ©rieur	SUB
uillers	uillers	QLF
uiuiani	-	NAM
archidiacono	archidiaconus archidiacre	SUB
aymenon	aymenon	NAM
cubreyo	cubreyo	VBE
cotin	cotin	SUB
breton	breton	NAM
io	hio s'entrouvrir, prÃ©senter des hiatus, Ãªtre bÃ©at, Ã©mettre, vomir, dÃ©clamer, convoiter	VBE
.	.	SENT
guillaume	guillaume	NAM
h	h	VBE
.	.	SENT
de	de de, du haut de, au cours de, immÃ©diatement aprÃ¨s, parmi	PRE
dicy	dicy	QLF
cancellario	cancellarius huissier, scribe, greffier, chancelier, notaire	SUB
ordeimonte	ordeimonte	SUB
branlart	branlart	NAM
confranc	confranc	VBE
clementis	clemens clÃ©ment	QLF
haultny	haultny	SUB
hubert	hubert	NAM
.	.	SENT
penitenciario	penitenciario	QLF
cardonnel	cardonnel	NAM
chacy	chacy	VBE
barre	bara civiÃ¨re|barra barriÃ¨re, bÃ¢ton, barre|barrus Ã©lÃ©phant	SUB
poyteuin	poyteuin	SUB
hodie	hodie aujourd'hui	ADV
dominus	dominus maÃ®tre, chef, seigneur, sire	SUB
fulco	-	NAM
maillard	maillard	NAM
presbyter	presbyter prÃªtre	SUB
filius	filius fils, enfant, disciple	SUB
richardi	-	NAM
maillard	maillard	NAM
presentatus	presento prÃ©senter	VBE
in	in dans, en, sur, selon, envers, pour, contre, Ã  propos de, vu, par, avec	PRE
capitulo	capitulum petite tÃªte, tÃªte, capuchon, coiffure, chapiteau, chapitre, chevet	SUB
par	par1 Ã©gal, pareil, appariÃ©	QLF
.	.	SENT
/	/	VBE
per	per Ã  travers, par, tout le long de, durant, pendant, au cours de, par le moyen de, par suite de	PRE
magistrum	magister2 maÃ®tre, bourgmestre, officier seigneurial	SUB
iacobum	-	NAM
de	de de, du haut de, au cours de, immÃ©diatement aprÃ¨s, parmi	PRE
cubreyo	cubreyo	QLF
canonicum	canonicus2 thÃ©oricien, clerc, chanoine	SUB
sancti	sanctus1 saint, sacrÃ©	QLF
mederici	-	NAM
par	par1 Ã©gal, pareil, appariÃ©	QLF
.	.	SENT
nomine	nomen nom, dÃ©nomination, titre, essence Â¶ nomine (+gÃ©n.) : au nom de, au titre de, Ã  cause Â¶ (pl.) reliques	SUB
aliorum	alius autre	QLF
canonicorum	canonicus2 thÃ©oricien, clerc, chanoine	SUB
ipsius	ipse2 lui-mÃªme, elle-mÃªme	PRO
sancti	sanctus1 saint, sacrÃ©	QLF
mederici	-	NAM
receptus	recipio recevoir, reprendre, accepter, admettre, approuver, prendre sur soi, exaucer Â¶ se r : rentrer, se ressaisir	VBE
est	sum Ãªtre, exister, signifier Â¶ est : il est possible, il s'agit de	VBE
in	in dans, en, sur, selon, envers, pour, contre, Ã  propos de, vu, par, avec	PRE
uicarium	uicarius2 remplaÃ§ant, vicaire	SUB
ipsius	ipse2 lui-mÃªme, elle-mÃªme	PRO
sancti	sanctus1 saint, sacrÃ©	QLF
mederici	-	NAM
ecclesie	ecclesia assemblÃ©e, communautÃ© de fidÃ¨les, Ã©glise	SUB
nomine	nomen nom, dÃ©nomination, titre, essence Â¶ nomine (+gÃ©n.) : au nom de, au titre de, Ã  cause Â¶ (pl.) reliques	SUB
et	et et	CON
pro	pro devant, en avant de, pour, en faveur de, Ã  la place de, en raison de	PRE
canonicis	canonica chanoinesse Â¶ Ã©glise canoniale, chapitre, canonicat, rÃ¨gle canoniale|canonicus2 thÃ©oricien, clerc, chanoine	SUB
eiusdem	idem1 (le) mÃªme, ledit, ce	QLF
ecclesie	ecclesia assemblÃ©e, communautÃ© de fidÃ¨les, Ã©glise	SUB
loco	locus lieu, place, passage (d'un Ã©crit), localitÃ©, monastÃ¨re	SUB
domini	dominus maÃ®tre, chef, seigneur, sire	SUB
guillelmi	-	NAM
per	per Ã  travers, par, tout le long de, durant, pendant, au cours de, par le moyen de, par suite de	PRE
capitulum	capitulum petite tÃªte, tÃªte, capuchon, coiffure, chapiteau, chapitre, chevet	SUB
commissum	committo unir, entreprendre, rendre exÃ©cutoire, risquer, administrer (un sacrement), compromettre, produire, enjoindre, consigner, confier, perdre son droit sur une tenure par un dÃ©lit (ou une omission)	VBE
et	et et	CON
repertus	reperio retrouver, dÃ©couvrir, imaginer	VBE
sufficiens	sufficiens suffisant, content de, valable, suffisamment important	QLF
et	et et	CON
fuit	sum Ãªtre, exister, signifier Â¶ est : il est possible, il s'agit de	VBE
installatus	installo installer	VBE
in	in dans, en, sur, selon, envers, pour, contre, Ã  propos de, vu, par, avec	PRE
choris	chora droit urbain, territoire, district|chore nocturnes contenant quelques psaumes|chorus choeur Â¶ territoire|corus mesure de capacitÃ©	SUB
ecclesie	ecclesia assemblÃ©e, communautÃ© de fidÃ¨les, Ã©glise	SUB
par	par1 Ã©gal, pareil, appariÃ©	QLF
.	.	SENT
per	per Ã  travers, par, tout le long de, durant, pendant, au cours de, par le moyen de, par suite de	PRE
dictum	dictum parole, sentence, proverbe, ordre	SUB
m	1000	NUM
.	.	SENT
i	1	NUM
.	.	SENT
barre	bara civiÃ¨re|barra barriÃ¨re, bÃ¢ton, barre|barrus Ã©lÃ©phant	SUB
/	/	VBE
et	et et	CON
ecclesie	ecclesia assemblÃ©e, communautÃ© de fidÃ¨les, Ã©glise	SUB
dicti	dictus dit, susdit	QLF
sancti	sanctus1 saint, sacrÃ©	QLF
postquam	postquam aprÃ¨s que, depuis que, comme	CON
fuit	sum Ãªtre, exister, signifier Â¶ est : il est possible, il s'agit de	VBE
examinatus	examinatus scrupuleux, de bon aloi, affinÃ©	QLF
per	per Ã  travers, par, tout le long de, durant, pendant, au cours de, par le moyen de, par suite de	PRE
magistrum	magister2 maÃ®tre, bourgmestre, officier seigneurial	SUB
iacobum	-	NAM
barre	bara civiÃ¨re|barra barriÃ¨re, bÃ¢ton, barre|barrus Ã©lÃ©phant	SUB
ad	ad vers, pour, prÃ¨s de, chez, Ã , jusqu'Ã , relativement Ã , d'aprÃ¨s, par suite de	PRE
hoc	hic3 celui-ci, celle-ci	PRO
mederici	-	NAM
per	per Ã  travers, par, tout le long de, durant, pendant, au cours de, par le moyen de, par suite de	PRE
notarioum	notarioum	QLF
capituli	capitulum petite tÃªte, tÃªte, capuchon, coiffure, chapiteau, chapitre, chevet	SUB
canonicatus	canonicatus canonicat	SUB
et	et et	CON
prebenda	prebenda allocation, prÃ©bende, distribution, cadeau	SUB
ecclesie	ecclesia assemblÃ©e, communautÃ© de fidÃ¨les, Ã©glise	SUB
sancti	sanctus1 saint, sacrÃ©	QLF
sepulcri	sepulcrum sÃ©pulcre, tombeau	SUB
par	par1 Ã©gal, pareil, appariÃ©	QLF
.	.	SENT
quos	qui2 qui, quel, lequel, quelque, quelqu'un|quis qui, que, quelqu'un, quelque	PRO
nuper	nuper maintenant, rÃ©cemment	ADV
obtinebat	obtineo obtenir, tenir solidement, garder, maintenir (ou Ã©tablir) une opinion, rÃ©ussir, durer	VBE
dominus	dominus maÃ®tre, chef, seigneur, sire	SUB
guillelmus	-	NAM
ruli	ruli	NAM
in	in dans, en, sur, selon, envers, pour, contre, Ã  propos de, vu, par, avec	PRE
eadem	idem1 (le) mÃªme, ledit, ce	QLF
ecclesia	ecclesia assemblÃ©e, communautÃ© de fidÃ¨les, Ã©glise	SUB
uacantes	uaco s'appliquer Ã , vaquer Ã , Ãªtre vacant	VBE
per	per Ã  travers, par, tout le long de, durant, pendant, au cours de, par le moyen de, par suite de	PRE
resignacionem	resignatio action de desceller	SUB
magistri	magister2 maÃ®tre, bourgmestre, officier seigneurial	SUB
iohannis	-	NAM
houselli	houselli	SUB
procuratoris	procurator administrateur, intendant, mandataire, procurateur	SUB
et	et et	CON
nomine	nomen nom, dÃ©nomination, titre, essence Â¶ nomine (+gÃ©n.) : au nom de, au titre de, Ã  cause Â¶ (pl.) reliques	SUB
procuratorio	procuratorius de procurateur, d'avouÃ©	QLF
licteratorie	licteratorie	QLF
fundati	fundo1 fonder, bÃ¢tir, asseoir solidement, donner les rudiments	VBE
dicti	dico2 dire, ordonner, chanter	VBE
domini	dominus maÃ®tre, chef, seigneur, sire	SUB
guillelmi	-	NAM
rubi	rubus ronce, framboisier, framboise Â¶ buisson ardent	SUB
hodie	hodie aujourd'hui	ADV
in	in dans, en, sur, selon, envers, pour, contre, Ã  propos de, vu, par, avec	PRE
manibus	manes mÃ¢nes, enfers|manus2 main, force, troupe, pouvoir, coup au jeu	SUB
capituli	capitulum petite tÃªte, tÃªte, capuchon, coiffure, chapiteau, chapitre, chevet	SUB
factam	facio faire, crÃ©er, agir|fio se produire, se rencontrer, devenir, Ãªtre crÃ©Ã©	VBE
et	et et	CON
admissam	admitto lancer (vers), accepter, admettre	VBE
/	/	VBE
causa	causa2 cause, excuse, prÃ©texte, occasion, procÃ¨s, affaire, conflit, cas, parti, acte, chose, maladie	SUB
tamen	tamen cependant, toutefois	CON
permutacionis	permutatio changement, permutation	SUB
/	/	VBE
de	de de, du haut de, au cours de, immÃ©diatement aprÃ¨s, parmi	PRE
ipsis	ipse2 lui-mÃªme, elle-mÃªme	PRO
cum	cum1 (+ abl.) avec	PRE
suis	suus son, sa, sien, sienne	QLF
iuribus	ius droit, justice Â¶ jus, sauce	SUB
et	et et	CON
pertinentis	pertineo s'Ã©tendre jusqu'Ã , relever de, succÃ©der Ã	VBE
uniuersis	uniuersus tout entier Â¶ (plur.) tous sans exception	QLF
cum	cum1 (+ abl.) avec	PRE
domino	dominus maÃ®tre, chef, seigneur, sire	SUB
iohanne	-	NAM
de	de de, du haut de, au cours de, immÃ©diatement aprÃ¨s, parmi	PRE
uastina	wastina terres incultes, gÃ¢tine	SUB
presbytero	presbyter prÃªtre	SUB
diocesis	diocesis diocÃ¨se, paroisse, province ecclÃ©siastique, Ã©glise paroissiale, autoritÃ© diocÃ©saine	SUB
cameracensis	-	NAM
capellano	capellanus2 chapelain	SUB
cappellanie	cappellanie	SUB
perpetue	perpetuus continu, perpÃ©tuel	QLF
ad	ad vers, pour, prÃ¨s de, chez, Ã , jusqu'Ã , relativement Ã , d'aprÃ¨s, par suite de	PRE
altare	altar autel, revenus d'un autel	SUB
beati	beatus bienheureux, riche, saint	QLF
dionisii	-	NAM
in	in dans, en, sur, selon, envers, pour, contre, Ã  propos de, vu, par, avec	PRE
cripta	crypta crypte, cachette, galerie couverte	SUB
monasteri	monasterium Ã©glise, monastÃ¨re	SUB
beate	beatus bienheureux, riche, saint	QLF
genouefe	-	NAM
par	par1 Ã©gal, pareil, appariÃ©	QLF
.	.	SENT
ad	ad vers, pour, prÃ¨s de, chez, Ã , jusqu'Ã , relativement Ã , d'aprÃ¨s, par suite de	PRE
dictam	dictus dit, susdit	QLF
capellaniam	capellania fonction de chapelain, chapelle royale, chapellenie	SUB
suaque	suaque	QLF
iura	ius droit, justice Â¶ jus, sauce	SUB
et	et et	CON
pertinentiis	pertinentia dÃ©pendance, domaine	SUB
uniuersis	uniuersus tout entier Â¶ (plur.) tous sans exception	QLF
et	et et	CON
non	non ne... pas, ne... point, non	ADV
alias	alius autre	QLF
faciende	facienda exploitation agricole	SUB
prestito	prestitum emprunt	SUB
prius	prius auparavant, jadis	ADV
per	per Ã  travers, par, tout le long de, durant, pendant, au cours de, par le moyen de, par suite de	PRE
dictum	dictum parole, sentence, proverbe, ordre	SUB
procuratorem	procurator administrateur, intendant, mandataire, procurateur	SUB
nomine	nomen nom, dÃ©nomination, titre, essence Â¶ nomine (+gÃ©n.) : au nom de, au titre de, Ã  cause Â¶ (pl.) reliques	SUB
quo	qui2 qui, quel, lequel, quelque, quelqu'un|quis qui, que, quelqu'un, quelque	PRO
supra	supra2 plus haut, en plus, d'une dignitÃ© supÃ©rieure	ADV
et	et et	CON
per	per Ã  travers, par, tout le long de, durant, pendant, au cours de, par le moyen de, par suite de	PRE
dictum	dictum parole, sentence, proverbe, ordre	SUB
de	de de, du haut de, au cours de, immÃ©diatement aprÃ¨s, parmi	PRE
uastina	wastina terres incultes, gÃ¢tine	SUB
iuramento	iuramentum serment, jurement	SUB
quod	qui2 qui, quel, lequel, quelque, quelqu'un|quot combien, aussi nombreux que, tout, chaque Â¶ tot... quot : autant... que	PRO
in	in dans, en, sur, selon, envers, pour, contre, Ã  propos de, vu, par, avec	PRE
huiusmodi	huiusmodi de cette maniÃ¨re, de cette sorte	ADV
permutacione	permutatio changement, permutation	SUB
et	et et	CON
resignacione	resignatio action de desceller	SUB
non	non ne... pas, ne... point, non	ADV
interuenient	interuenio survenir, intervenir, s'interposer, intercÃ©der	VBE
fraus	fraus tromperie, crime, mÃ©prise, dÃ©triment	SUB
dolus	dolus douleur Â¶ ruse, tort causÃ©	SUB
etc	etc	VBE
.	.	SENT
per	per Ã  travers, par, tout le long de, durant, pendant, au cours de, par le moyen de, par suite de	PRE
deliberacionem	deliberatio dÃ©libÃ©ration, consultation, dÃ©cret Â¶ dÃ©livrance, garantie, donation	SUB
capituli	capitulum petite tÃªte, tÃªte, capuchon, coiffure, chapiteau, chapitre, chevet	SUB
collati	collatus combat, confÃ©rence, donation, impÃ´t, action de recueillir	SUB
sunt	sum Ãªtre, exister, signifier Â¶ est : il est possible, il s'agit de	VBE
prefato	prefatus susdit	QLF
domino	dominus maÃ®tre, chef, seigneur, sire	SUB
iohanni	-	NAM
de	de de, du haut de, au cours de, immÃ©diatement aprÃ¨s, parmi	PRE
uastina	wastina terres incultes, gÃ¢tine	SUB
presbytero	presbyter prÃªtre	SUB
ibidem	ibidem lÃ  mÃªme, au mÃªme moment	ADV
presenti	presens prÃ©sent, visible, efficace, secourable, favorable, de sang froid, rÃ©solu	QLF
qui	qui2 qui, quel, lequel, quelque, quelqu'un|quis qui, que, quelqu'un, quelque	PRO
iurauit	iuro jurer	VBE
in	in dans, en, sur, selon, envers, pour, contre, Ã  propos de, vu, par, avec	PRE
forma	forma forme, type, beautÃ©, moule	SUB
soluit	soluo dÃ©lier, dÃ©livrer, acquitter, payer, rompre, relÃ¢cher, anÃ©antir, se dÃ©sister, renoncer Ã	VBE
xxxiiii	34	NUM
s	signum anneau sigillaire, sceau, seing manuel, monogramme, borne, marque, signe, symbole, signal, cloche, prodige, miracle	SUB
.	.	SENT
pro	pro devant, en avant de, pour, en faveur de, Ã  la place de, en raison de	PRE
sua	suus son, sa, sien, sienne	QLF
recepcione	receptio action de recevoir ou de recouvrer, action de rÃ©server, garder par devers soi, gÃ®te imposÃ© en vertu du droit de gÃ®te, recette	SUB
ut	ut comment, comme, combien Â¶ (+ indic.) : de mÃªme que, quand, vu que Â¶ (+ subj.) : que, Ã  savoir que, pour que, de sorte que, tellement que, si bien que, Ã  supposer que Â¶ (+ part. futur) : avec l'intention de, comme pour	CON
est	sum Ãªtre, exister, signifier Â¶ est : il est possible, il s'agit de	VBE
consuetum	consuetus habituel, accoutumÃ©	QLF
et	et et	CON
fuit	sum Ãªtre, exister, signifier Â¶ est : il est possible, il s'agit de	VBE
installatus	installo installer	VBE
in	in dans, en, sur, selon, envers, pour, contre, Ã  propos de, vu, par, avec	PRE
choro	chorus choeur Â¶ territoire|corus mesure de capacitÃ©	SUB
ecclesie	ecclesia assemblÃ©e, communautÃ© de fidÃ¨les, Ã©glise	SUB
par	par1 Ã©gal, pareil, appariÃ©	QLF
.	.	SENT
per	per Ã  travers, par, tout le long de, durant, pendant, au cours de, par le moyen de, par suite de	PRE
magistrum	magister2 maÃ®tre, bourgmestre, officier seigneurial	SUB
ia	hio s'entrouvrir, prÃ©senter des hiatus, Ãªtre bÃ©at, Ã©mettre, vomir, dÃ©clamer, convoiter	VBE
.	.	SENT
barre	bara civiÃ¨re|barra barriÃ¨re, bÃ¢ton, barre|barrus Ã©lÃ©phant	SUB
commissum	committo unir, entreprendre, rendre exÃ©cutoire, risquer, administrer (un sacrement), compromettre, produire, enjoindre, consigner, confier, perdre son droit sur une tenure par un dÃ©lit (ou une omission)	VBE
ad	ad vers, pour, prÃ¨s de, chez, Ã , jusqu'Ã , relativement Ã , d'aprÃ¨s, par suite de	PRE
cantoriam	cantoria chantrerie, office de chantre	SUB
et	et et	CON
succentor	succentor chanteur qui accompagne, sous-chantre, conseiller, instigateur	SUB
ipsius	ipse2 lui-mÃªme, elle-mÃªme	PRO
ecclesie	ecclesia assemblÃ©e, communautÃ© de fidÃ¨les, Ã©glise	SUB
par	par1 Ã©gal, pareil, appariÃ©	QLF
.	.	SENT
et	et et	CON
per	per Ã  travers, par, tout le long de, durant, pendant, au cours de, par le moyen de, par suite de	PRE
notarium	notarius1 relatif Ã  l'Ã©criture	QLF
capitulo	capitulum petite tÃªte, tÃªte, capuchon, coiffure, chapiteau, chapitre, chevet	SUB
in	in dans, en, sur, selon, envers, pour, contre, Ã  propos de, vu, par, avec	PRE
choro	chorus choeur Â¶ territoire|corus mesure de capacitÃ©	SUB
dicte	dictus dit, susdit	QLF
ecclesie	ecclesia assemblÃ©e, communautÃ© de fidÃ¨les, Ã©glise	SUB
sepulcri	sepulcrum sÃ©pulcre, tombeau	SUB
.	.	SENT
hodie	hodie aujourd'hui	ADV
magister	magister2 maÃ®tre, bourgmestre, officier seigneurial	SUB
clemens	clemens clÃ©ment	QLF
de	de de, du haut de, au cours de, immÃ©diatement aprÃ¨s, parmi	PRE
falcabergua	falcabergua	QLF
canonicus	canonicus2 thÃ©oricien, clerc, chanoine	SUB
par	par1 Ã©gal, pareil, appariÃ©	QLF
.	.	SENT
nuper	nuper maintenant, rÃ©cemment	ADV
rediens	redeo revenir, retourner	VBE
de	de de, du haut de, au cours de, immÃ©diatement aprÃ¨s, parmi	PRE
partibus	pars part, partie, partage, parti Â¶ (pl.) rÃ´le (d'un acteur), parti|partus accouchement	SUB
picardie	picardie	SUB
hic	hic1 ici, sur ce point, alors	ADV
fecit	facio faire, crÃ©er, agir	VBE
suam	suus son, sa, sien, sienne	QLF
relacionem	relatio rapport, mise en dÃ©libÃ©ration, relation, narration, charge assignÃ©e Ã  quelqu'un	SUB
de	de de, du haut de, au cours de, immÃ©diatement aprÃ¨s, parmi	PRE
negociis	negotium affaire, occupation, travail, chose, marchandise, marchÃ©, activitÃ© politique, litige	SUB
ecclesie	ecclesia assemblÃ©e, communautÃ© de fidÃ¨les, Ã©glise	SUB
par	par1 Ã©gal, pareil, appariÃ©	QLF
.	.	SENT
uidelicet	uidelicet il va de soi, bien sÃ»r, sans doute, apparemment  Â¶ c'est-Ã -dire	ADV
de	de de, du haut de, au cours de, immÃ©diatement aprÃ¨s, parmi	PRE
facto	factum action, punition, redevance|factus exploitation, construction, quantitÃ© d'huile fournie par un tour de pressoir	SUB
d'oultrebays	d'oultrebays	SUB
d'ayencourt	d'ayencourt	NAM
et	et et	CON
de	de de, du haut de, au cours de, immÃ©diatement aprÃ¨s, parmi	PRE
domino	dominus maÃ®tre, chef, seigneur, sire	SUB
uicedomino	uicedominus reprÃ©sentant, vidame, vice-roi	SUB
ambianensi	-	NAM
et	et et	CON
retulit	refero rapporter, restituer, payer, proposer une motion, en appeler Ã , revenir dire, rendre compte, reproduire Â¶ refert : il importe, il est de l'intÃ©rÃªt de|retollo remporter	VBE
intercetera	intercetera	VBE
recepisse	recipio recevoir, reprendre, accepter, admettre, approuver, prendre sur soi, exaucer Â¶ se r : rentrer, se ressaisir	VBE
de	de de, du haut de, au cours de, immÃ©diatement aprÃ¨s, parmi	PRE
terra	terra terre, sol, territoire, pays, monde	SUB
d'oultrebays	d'oultrebays	SUB
solum	solum1 seulement	ADV
xui	16	NUM
£	£	VBE
.	.	SENT
que	que (enclit.) et	CON
ordinate	ordinate en ordre, rÃ©guliÃ¨rement	ADV
sunt	sum Ãªtre, exister, signifier Â¶ est : il est possible, il s'agit de	VBE
tradi	trado livrer, remettre, trahir, transmettre, enseigner, expliquer	VBE
per	per Ã  travers, par, tout le long de, durant, pendant, au cours de, par le moyen de, par suite de	PRE
ipsum	ipse2 lui-mÃªme, elle-mÃªme	PRO
m	1000	NUM
.	.	SENT
cle	cle	VBE
.	.	SENT
officiario	officiarium livre contenant les offices|officiarius officier, agent, official, membre d'une maison ecclÃ©siastique, serviteur, agent domanial, appariteur judiciaire	SUB
anniuersariorum	anniuersarius anniversaire	SUB
pro	pro devant, en avant de, pour, en faveur de, Ã  la place de, en raison de	PRE
negociis	negotium affaire, occupation, travail, chose, marchandise, marchÃ©, activitÃ© politique, litige	SUB
sui	suus son, sa, sien, sienne	QLF
officii	officium service, fonction, obligeance, devoir, obÃ©issance, secours, activitÃ©, ouvrage, office	SUB
quia	quia parce que, de ce que, que	CON
ad	ad vers, pour, prÃ¨s de, chez, Ã , jusqu'Ã , relativement Ã , d'aprÃ¨s, par suite de	PRE
eius	is2 il, elle, le, la, les	PRO
officium	officium service, fonction, obligeance, devoir, obÃ©issance, secours, activitÃ©, ouvrage, office	SUB
spectant	specto regarder, considÃ©rer, examiner, Ã©prouver, avoir en vue, donner sur	VBE
/	/	VBE
et	et et	CON
audita	audio Ã©couter, entendre, comprendre, obÃ©ir	VBE
eius	is2 il, elle, le, la, les	PRO
relacione	relatio rapport, mise en dÃ©libÃ©ration, relation, narration, charge assignÃ©e Ã  quelqu'un	SUB
ordinatum	ordino ordonner, administrer, rÃ©gler, lÃ©guer	VBE
est	sum Ãªtre, exister, signifier Â¶ est : il est possible, il s'agit de	VBE
quo	qui2 qui, quel, lequel, quelque, quelqu'un|quis qui, que, quelqu'un, quelque	PRO
ad	ad vers, pour, prÃ¨s de, chez, Ã , jusqu'Ã , relativement Ã , d'aprÃ¨s, par suite de	PRE
factum	factum action, punition, redevance|factus exploitation, construction, quantitÃ© d'huile fournie par un tour de pressoir	SUB
dicti	dictus dit, susdit	QLF
d'oultrebays	d'oultrebays	SUB
quod	qui2 qui, quel, lequel, quelque, quelqu'un|quot combien, aussi nombreux que, tout, chaque Â¶ tot... quot : autant... que	PRO
uideatur	uideo voir, comprendre, veiller Ã  Â¶ (pass.) Ãªtre vu, sembler	VBE
declaracio	declaratio manifestation, montre, explication	SUB
redditus	redditus1 frÃ¨re convers|redditus2 remise, don, redevance|reditus retour, retraite, revenu, rÃ©volution (astre)	SUB
dicti	dictus dit, susdit	QLF
d'oultrebays	d'oultrebays	SUB
ut	ut comment, comme, combien Â¶ (+ indic.) : de mÃªme que, quand, vu que Â¶ (+ subj.) : que, Ã  savoir que, pour que, de sorte que, tellement que, si bien que, Ã  supposer que Â¶ (+ part. futur) : avec l'intention de, comme pour	CON
super	super sur, au-dessus (de), prÃ¨s de, au sujet de, envers, contre, en plus de, plus que, Ã  cause de, pendant, sur, sous peine de, au risque de	PRE
hoc	hic3 celui-ci, celle-ci	PRO
prouideatur	prouideo prÃ©voir, pourvoir, prÃ©parer, veiller sur	VBE
domini	dominus maÃ®tre, chef, seigneur, sire	SUB
mei	meus mon, mien	QLF
.	.	SENT
decanus	decanus dizenier ou doyen, personne placÃ©e Ã  la tÃªte de dix autres, supÃ©rieur	SUB
uillers	uillers	QLF
.	.	SENT
cotin	cotin	SUB
et	et et	CON
h	h	VBE
.	.	SENT
de	de de, du haut de, au cours de, immÃ©diatement aprÃ¨s, parmi	PRE
dicy	dicy	QLF
tractabunt	tracto traÃ®ner, diffÃ©rer, traiter (de), maltraiter, toucher, manier, gÃ©rer, commenter, mÃ©diter, prÃªcher, manigancer	VBE
cum	cum1 (+ abl.) avec	PRE
magistro	magister2 maÃ®tre, bourgmestre, officier seigneurial	SUB
iohanne	-	NAM
chanteprime	chanteprime	SUB
super	super sur, au-dessus (de), prÃ¨s de, au sujet de, envers, contre, en plus de, plus que, Ã  cause de, pendant, sur, sous peine de, au risque de	PRE
hoc	hic3 celui-ci, celle-ci	PRO
que	que (enclit.) et	CON
petit	peto se diriger vers, demander	VBE
capitulo	capitulum petite tÃªte, tÃªte, capuchon, coiffure, chapiteau, chapitre, chevet	SUB
par	par1 Ã©gal, pareil, appariÃ©	QLF
.	.	SENT
racione	ratio calcul, compte, intÃ©rÃªts, affaires, registre, rÃ´le, liste, mÃ©thode, plan, thÃ©orie, raison, raisonnement, conduite, moyen, maniÃ¨re, justification, revendication, plaidoyer, justice faite au plaignant, cause (pl.), propriÃ©tÃ©, part, contrat, clause, condition, redevance	SUB
sue	suus son, sa, sien, sienne	QLF
capellanie	capellania fonction de chapelain, chapelle royale, chapellenie	SUB
sancti	sanctus1 saint, sacrÃ©	QLF
stephani	-	NAM
prothomartiris	protomartyr protomartyr (Etienne)	SUB
in	in dans, en, sur, selon, envers, pour, contre, Ã  propos de, vu, par, avec	PRE
dicta	dictum parole, sentence, proverbe, ordre	SUB
ecclesia	ecclesia assemblÃ©e, communautÃ© de fidÃ¨les, Ã©glise	SUB
/	/	VBE
et	et et	CON
refferent	refferent	VBE
domini	dominus maÃ®tre, chef, seigneur, sire	SUB
mei	meus mon, mien	QLF
.	.	SENT
decanus	decanus dizenier ou doyen, personne placÃ©e Ã  la tÃªte de dix autres, supÃ©rieur	SUB
.	.	SENT
et	et et	CON
barre	bara civiÃ¨re|barra barriÃ¨re, bÃ¢ton, barre|barrus Ã©lÃ©phant	SUB
examinabunt	examino essaimer, interroger, examiner	VBE
m	1000	NUM
.	.	SENT
io	io ah ! oh ! las !	INT
.	.	SENT
melleti	melletus tissu mÃ©langÃ©	SUB
utrum	utrum est-ce que, si Â¶ utrum... an : est-ce que... ou bien, si.... ou bien si	CON
sit	sum Ãªtre, exister, signifier Â¶ est : il est possible, il s'agit de	VBE
sufficiens	sufficiens suffisant, content de, valable, suffisamment important	QLF
ad	ad vers, pour, prÃ¨s de, chez, Ã , jusqu'Ã , relativement Ã , d'aprÃ¨s, par suite de	PRE
obtinendum	obtineo obtenir, tenir solidement, garder, maintenir (ou Ã©tablir) une opinion, rÃ©ussir, durer	VBE
magnam	magnus grand, magnanime, emphatique	QLF
uicariam	uicaria remplaÃ§ante, rechange Â¶ viguerie, vicairie	SUB
ecclesie	ecclesia assemblÃ©e, communautÃ© de fidÃ¨les, Ã©glise	SUB
par	par1 Ã©gal, pareil, appariÃ©	QLF
.	.	SENT
nuper	nuper maintenant, rÃ©cemment	ADV
uacante	uaco s'appliquer Ã , vaquer Ã , Ãªtre vacant	VBE
per	per Ã  travers, par, tout le long de, durant, pendant, au cours de, par le moyen de, par suite de	PRE
obitum	obitus arrivÃ©e, visite, coucher (des astres), fin, trÃ©pas, destruction, accomplissement, exÃ©cution, obit	SUB
deffuncti	deffuncti	VBE
magistri	magister2 maÃ®tre, bourgmestre, officier seigneurial	SUB
nicolai	nicolaus variÃ©tÃ© de datte	SUB
sellarii	sellaris2 cheval de selle|sellarium selle|sellarius sellier	SUB
presbyteri	presbyter prÃªtre	SUB
dum	dum (indic.) pendant que, aussi longtemps que, jusqu'au moment oÃ¹, (subj.) jusqu'Ã  ce que, pourvu que, comme, alors que	CON
uiueret	uiuo vivre	VBE
eiusdem	idem2 le-mÃªme, ledit	PRO
possessoris	possessor possesseur, propriÃ©taire	SUB
ad	ad vers, pour, prÃ¨s de, chez, Ã , jusqu'Ã , relativement Ã , d'aprÃ¨s, par suite de	PRE
quam	qui2 qui, quel, lequel, quelque, quelqu'un|quis qui, que, quelqu'un, quelque	PRO
uicariam	uicaria remplaÃ§ante, rechange Â¶ viguerie, vicairie	SUB
decanus	decanus dizenier ou doyen, personne placÃ©e Ã  la tÃªte de dix autres, supÃ©rieur	SUB
et	et et	CON
capitulum	capitulum petite tÃªte, tÃªte, capuchon, coiffure, chapiteau, chapitre, chevet	SUB
sancti	sanctus1 saint, sacrÃ©	QLF
marcelli	martellus petit marteau	SUB
presentauerunt	presento prÃ©senter	VBE
ipsum	ipse2 lui-mÃªme, elle-mÃªme	PRO
melleti	melletus tissu mÃ©langÃ©	SUB
capitulo	capitulum petite tÃªte, tÃªte, capuchon, coiffure, chapiteau, chapitre, chevet	SUB
par	par1 Ã©gal, pareil, appariÃ©	QLF
.	.	SENT
et	et et	CON
quam	quam que, combien, Ã  quel point	CON
sibi	se se, soi	PRO
conferii	conferii	VBE
per	per Ã  travers, par, tout le long de, durant, pendant, au cours de, par le moyen de, par suite de	PRE
capitulum	capitulum petite tÃªte, tÃªte, capuchon, coiffure, chapiteau, chapitre, chevet	SUB
par	par1 Ã©gal, pareil, appariÃ©	QLF
.	.	SENT
petit	peto se diriger vers, demander	VBE
et	et et	CON
requirit	requiro rechercher, rÃ©clamer, ne pas trouver, regretter, percevoir	VBE
et	et et	CON
refferent	refferent	VBE
ueneris	uenus VÃ©nus, amour, charme, mai Â¶ vente	SUB
sequenti	sequens suivant, d'un rang infÃ©rieur Â¶ sequentes, ium, (m. pl.) la postÃ©ritÃ©	QLF
ultima	ultimus ultime Â¶ ultima, orum, (n. pl.) les derniers moments de la vie	QLF
nouembris	nouember novembre	SUB
fuit	sum Ãªtre, exister, signifier Â¶ est : il est possible, il s'agit de	VBE
festum	festa1 faÃ®te, fÃ»t de faÃ®tage Â¶ fÃªte	SUB
sancti	sanctus1 saint, sacrÃ©	QLF
andree	-	NAM
apostoli	apostoli lettres de renvoi|apostolus apÃ´tre, pape Â¶ lettre d'appel ou de crÃ©ance	SUB
.	.	SENT
266	@card@	INT
de	de de, du haut de, au cours de, immÃ©diatement aprÃ¨s, parmi	PRE
io	ion violette (bot.), variÃ©tÃ© de pierre prÃ©cieuse	SUB
.	.	SENT
symon	-	NAM
cccc_	cccc_	NUM
recepcio	receptio action de recevoir ou de recouvrer, action de rÃ©server, garder par devers soi, gÃ®te imposÃ© en vertu du droit de gÃ®te, recette	SUB
uicarii	uicarius1 reprÃ©sentant, successeur, rÃ©ciproque	QLF
sancti	sanctus1 saint, sacrÃ©	QLF
mederici	-	NAM
parisiensis	-	NAM
ecclesie	ecclesia assemblÃ©e, communautÃ© de fidÃ¨les, Ã©glise	SUB
sepulcri	sepulcrum sÃ©pulcre, tombeau	SUB
parisiensis	-	NAM
m	1000	NUM
.	.	SENT
io	io ah ! oh ! las !	INT
.	.	SENT
chanteprime	chanteprime	SUB
deputati	deputo tailler, estimer, affecter Ã , enjoindre, convenir	VBE
ad	ad vers, pour, prÃ¨s de, chez, Ã , jusqu'Ã , relativement Ã , d'aprÃ¨s, par suite de	PRE
examinandum	examino essaimer, interroger, examiner	VBE
festum	festa1 faÃ®te, fÃ»t de faÃ®tage Â¶ fÃªte	SUB
copia	copia abondance, ressources, pouvoir, copie Â¶ (pl.) troupes	SUB
lictere	lictere	SUB
presentacionis	presentatio prÃ©sentation, collation, cadeau	SUB
m	1000	NUM
.io	.io	VBE
.	.	SENT
melleti	melletus tissu mÃ©langÃ©	SUB
ad	ad vers, pour, prÃ¨s de, chez, Ã , jusqu'Ã , relativement Ã , d'aprÃ¨s, par suite de	PRE
uicariam	uicaria remplaÃ§ante, rechange Â¶ viguerie, vicairie	SUB
collacio	colatium mÃ©tayage|collatio assemblage, rÃ©union, confrontation, contribution, don, comparaison, rapprochement, collation	SUB
canonicatus	canonicatus canonicat	SUB
et	et et	CON
prebende	prebenda allocation, prÃ©bende, distribution, cadeau	SUB
falcaberga	falcaberga	VBE
de	de de, du haut de, au cours de, immÃ©diatement aprÃ¨s, parmi	PRE
picardia	picardia	SUB
m	1000	NUM
.	.	SENT
io	io ah ! oh ! las !	INT
.	.	SENT
melleti	melletus tissu mÃ©langÃ©	SUB
