form	lemma	POS morph
Sn	Sn	SCONJ
.xxx	.xxx	NOUN
.	.	PUNCT
Guilbet	Guilbeo	VERB
Martis	Mars	NOUN
in	in	ADP
crastinum	crastinus	NOUN
festi	festus	ADJ
sancti	sanceo	NOUN
Gendulphi	Gendulphus	NOUN
i	is	VERB
sols	sols	NOUN
val	val	CCONJ
xiiiia	xiiiia	NOUN
novembris	novembrum	NOUN
prima	primus	ADJ
capituli	capitulus	NOUN
generalis	generalis	NOUN
sancti	sanctus	NOUN
Martini	Martinus	NOUN
hiemalis	hiemalis	ADJ
fuerunt	sum	VERB
ad	ad	ADP
capitulum	capitulus	NOUN
et	et	CCONJ
lucrati	lucro	VERB
fuerunt	sum	VERB
domini	dominus	NOUN
infrascripti	infrascriptus	VERB
videlicet	videlicet	ADV
archidiaconus	archidiaconus	NOUN
de	de	ADP
Josayo	Josayum	NOUN
.	.	PUNCT
Succentor	Succentor	NOUN
.	.	PUNCT
Cancellarius	Cancellarius	NOUN
.	.	PUNCT
Penitenciarius	Penitenciarius	NOUN
.	.	PUNCT
Ordeimonte	Ordeimons	ADV
Chacy	Chacy	ADV
.	.	PUNCT
Breton	Breton	SCONJ
Gaillon	Gaillon	NOUN
.	.	PUNCT
Barre	Barr	VERB
.	.	PUNCT
Haultny	Haultny	ADV
.	.	PUNCT
Du	Dus	ADV
Drac	drac	CCONJ
.	.	PUNCT
De	de	ADP
Croces	Crox	NOUN
Aguenin	Aguen	SCONJ
Paillard	Paillars	ADP
.	.	PUNCT
Monneti	Monnetus	VERB
.	.	PUNCT
Parenti	Parentum	NOUN
.	.	PUNCT
Jerson	Jerson	NOUN
.	.	PUNCT
Fourbeur	Fourbeur	ADV
.	.	PUNCT
Fraxinis	Fraxen	NOUN
Boullard	Boullard	PRON
Sohier	Sohier	NOUN
.	.	PUNCT
Pion	Pion	NOUN
.	.	PUNCT
Bouchier	Bouchier	NOUN
.	.	PUNCT
Burdelot	Burdelot	VERB
Mondidier	Mondidier	NOUN
P	P	NOUN
.	.	PUNCT
Thomas	Thoma	NOUN
.	.	PUNCT
De	de	VERB
Cameraco	Cameraco	NOUN
.	.	PUNCT
Bussi	Bussus	VERB
excusatus	excuso	VERB
.	.	PUNCT
Victri	Victer	NOUN
.	.	PUNCT
Despars	Despars	NOUN
excusatus	excuso	VERB
Istud	Istud	ADP
capitulum	capitulus	NOUN
durat	duro	VERB
per	per	ADP
iiiior	iiiis	ADJ
dies	dies	NOUN
et	et	CCONJ
lucratur	lucror	VERB
quilibet	quilibeo	VERB
canonicus	canonicus	NOUN
pro	pro	ADP
qualibet	qualibeo	VERB
die	dies	NOUN
v	v	ADV
s	senatus	NOUN
.	.	PUNCT
p.	publicus	NOUN
et	et	CCONJ
pro	pro	ADP
prima	primus	ADJ
die	dies	NOUN
quilibet	quilibeo	VERB
vi	vis	NOUN
s	senatus	NOUN
.	.	PUNCT
p.	publicus	ADJ
quos	qui	PRON
debent	debeo	VERB
solvere	solvo	VERB
officiarii	officiarium	NOUN
anniversariorum	anniversarius	NOUN
et	et	CCONJ
vini	vo	NOUN
et	et	CCONJ
quos	qui	PRON
solvit	solvo	VERB
pro	pro	ADP
ista	iste	ADJ
vice	vix	NOUN
magister	magiss	ADV
Vincencius	Vincenx	ADV
de	de	ADP
Croces	Crox	NOUN
canonicus	canonicus	NOUN
et	et	CCONJ
officiarius	officiarius	NOUN
dictorum	dictus	NOUN
officiorum	officium	NOUN
et	et	CCONJ
est	sum	VERB
ordinatum	ordino	VERB
principaliter	principalis	ADV
ad	ad	ADP
audiendum	audio	ADJ
compota	compoveo	VERB
dictorum	dictus	NOUN
officiorum	officium	NOUN
et	et	CCONJ
ad	ad	ADP
ipsos	ipse	PRON
continuandum	continuo	VERB
vel	vel	CCONJ
de	de	ADP
aliis	alius	NOUN
providendum	provideo	VERB
.	.	PUNCT
Capellania	Capellania	NOUN
d'Oultrebays	d'Oultrebays	NOUN
ad	ad	ADP
presentacionem	presentacio	NOUN
capituli	capitulus	NOUN
spectans	specto	VERB
declaratur	declaro	VERB
vacans	vaco	ADJ
per	per	ADP
obitum	obitus	NOUN
Johannis	Johannus	NOUN
de	de	ADP
Chailli	Chaillus	NOUN
ultimi	ultimis	NOUN
possessoris	possessor	NOUN
eiusdem	idem	PRON
audita	audio	VERB
prius	prior	ADV
Declaracio	Declaracium	NOUN
vacacionis	vacacio	NOUN
relacione	relacio	NOUN
magistri	magister	ADJ
Johannis	Johannus	ADJ
du	dus	NOUN
Drac	Dratque	PRON
canonici	canonicio	VERB
Par	par	VERB
.	.	PUNCT
qui	qui	PRON
retulit	refero	VERB
ipsum	ipse	PRON
de	de	ADP
Chailli	Chaillus	NOUN
capellanie	capellanies	NOUN
fore	sum	VERB
deffunctum	deffunco	VERB
presente	presens	ADV
magistro	magister	ADJ
Petro	Petrum	ADJ
d'Orgemont	d'Orgemoo	VERB
existente	existo	VERB
in	in	ADP
turno	turnus	ADJ
parvo	parvus	NOUN
Dampnart	Dampnaro	VERB
Commictitur	Commictitur	CCONJ
discrecioni	discreciono	VERB
m	s	NOUN
.	.	PUNCT
Vincencii	Vincencium	ADV
de	de	ADP
Croces	Crox	NOUN
officiarii	officiarium	NOUN
de	de	ADP
tractando	tracto	VERB
cum	cum	SCONJ
quibusdam	quidam	PRON
hominibus	homo	NOUN
pro	pro	ADP
firma	firma	NOUN
de	de	ADP
Dampnart	Dampnaro	VERB
et	et	CCONJ
refferendo	reffero	VERB
Magister	Magister	NOUN
Vincencius	Vincencius	NOUN
de	de	ADP
Croces	Crox	NOUN
oneratus	oneratus	NOUN
est	sum	VERB
de	de	ADP
scribendo	scribo	VERB
apud	apud	ADP
Leschelles	Leschellis	NOUN
Leschelles	Leschellis	NOUN
prope	prope	ADV
Jongny	Jongny	ADV
/	/	PUNCT
ad	ad	ADP
sciendum	scio	VERB
quantum	quantus	ADJ
poterit	possum	VERB
valere	valeo	VERB
domus	domus	NOUN
.	.	PUNCT
274	274	NUM
