form	lemma	POS morph
xi	co	VERB
xviii	duodecviim	NUM
465	465	NUM
.	.	PUNCT
Lune	Lu	NOUN
post	post	ADP
ramos	ramus	NOUN
ultimi	ultimis	NOUN
marcii	marcius	ADJ
capitulantibus	capitulantis	NOUN
dominis	dominus	NOUN
.	.	PUNCT
Cantore	Cantor	NOUN
.	.	PUNCT
De	de	ADP
Croces	Crox	NOUN
.	.	PUNCT
Secretain	Secreta	NOUN
.	.	PUNCT
Succentore	Succentor	NOUN
.	.	PUNCT
Victry	Victry	ADV
.	.	PUNCT
Harenger	Harenger	NOUN
.	.	PUNCT
Cancellario	Cancellarium	NOUN
.Mondidier	.Mondidier	VERB
.	.	PUNCT
Le	L	VERB
Herpeur	Herpeur	ADV
.	.	PUNCT
Penitenciario	Penitenciarium	NOUN
.	.	PUNCT
Aguenin	Aguen	SCONJ
.Josas	.Josa	VERB
.	.	PUNCT
Pion	Pion	NOUN
.	.	PUNCT
Chacy	Chacy	ADV
.	.	PUNCT
De	de	ADP
Brolio	Brolium	NOUN
.	.	PUNCT
Sohier	Sohier	ADP
.Breton	.Breton	NOUN
.Parenti	.Parentum	NOUN
.	.	PUNCT
Boullardi	Boullardus	NOUN
.	.	PUNCT
Cotin	Cotin	ADP
.Jerson	.Jerson	NOUN
.	.	PUNCT
P	P	NOUN
Thomas	Thoma	VERB
.	.	PUNCT
Gaillon	Gaillon	SCONJ
Monneti	Monnetus	NOUN
$Burdelot$	$Burdelot$	ADV
.Barre	.Barr	VERB
.	.	PUNCT
Luillier	Luillier	NOUN
.	.	PUNCT
Boucher	Boucher	NOUN
.	.	PUNCT
Haultny	Haultny	ADV
.	.	PUNCT
Fraxinis	Fraxinus	ADJ
.Du	.Dus	NOUN
Drac	Dratque	PRON
.	.	PUNCT
Poytevin	Poytevin	SCONJ
Despars	Despars	NOUN
excusato	excuso	VERB
hodie	hodies	NOUN
domini	dominus	NOUN
commissarii	commissarius	ADJ
videlicet	videlicet	ADV
Succentor	Succentor	NOUN
Cancellarius	Cancellarius	NOUN
Monneti	Monnetus	NOUN
fecerunt	facio	VERB
suum	suus	PRON
relacionem	relacio	NOUN
de	de	ADP
compotis	composco	NOUN
m	s	NOUN
.	.	PUNCT
V	V	ADV
.	.	PUNCT
de	de	ADP
Croces	Crox	NOUN
officiarii	officiarium	NOUN
anniversariorum	anniversarius	NOUN
et	et	CCONJ
debet	debeo	VERB
iiiC	iiiC	X
xiii	xiium	NUM
£	£	SYM
.	.	PUNCT
Et	et	CCONJ
audita	audio	VERB
eorum	is	PRON
relacione	relacio	NOUN
ordinatum	ordino	VERB
est	sum	VERB
quod	qui	PRON
fiat	fio	VERB
distribucio	distribucium	NOUN
et	et	CCONJ
tabula	tabula	NOUN
ad	ad	ADP
manutenendum	manuteno	VERB
reparacionem	reparacio	NOUN
hodie	hodies	NOUN
dominus	dominus	NOUN
ᑕantor	ᑕantor	NOUN
retulit	refero	VERB
quod	quod	SCONJ
ipse	ipse	PRON
tenetur	teneo	VERB
$ad	$ad	PRON
reparaciones$	reparaciones$	ADV
librorum	librus	NOUN
cantus	cantus	VERB
chori	chorior	VERB
ecclesie	ecclesies	ADV
/	/	PUNCT
requirens	requiro	VERB
quod	quod	SCONJ
domini	dominus	NOUN
facerent	facio	VERB
ipsos	ipse	PRON
reparari	reparo	VERB
et	et	CCONJ
postmodum	postmodum	SCONJ
ipse	ipse	PRON
manutenebit	manuteneo	VERB
ipsos	ipse	PRON
/	/	PUNCT
quodque	quodque	PRON
ipse	ipse	PRON
fecit	facio	VERB
nuper	nuper	ADV
repari	repo	VERB
unum	unus	NUM
exad	exas	PRON
videlicet	videlicet	VERB
quendam	quidam	PRON
antiphonarium	antiphonarius	ADJ
capituli	capitulus	NOUN
requirens	requiro	VERB
quod	quod	PRON
capitulum	capitulus	NOUN
solvat	solvo	VERB
reparacionem	reparacio	NOUN
que	que	CCONJ
de	de	ADP
xxicii	xxicium	NOUN
s	senatus	NOUN
.	.	PUNCT
et	et	CCONJ
postea	postea	ADV
manutenebit	manuteneo	VERB
Super	super	ADP
quo	qui	PRON
ordinatum	ordino	VERB
quod	quod	PRON
libri	liber	NOUN
cantus	cantus	NOUN
liber	liber	ADJ
et	et	CCONJ
alii	alius	ADJ
reperitur	reperio	VERB
de	de	ADP
peccuniis	peccunium	NOUN
cantorie	cantories	NOUN
$vid	$vid	ADV
sed$	sed$	ADV
videlicet	videlicet	ADV
de	de	ADP
fructibus	fructus	NOUN
prebende	prebende	ADV
foranee	forane	ADV
repertis	repero	VERB
per	per	ADP
m	s	NOUN
.	.	PUNCT
V	V	NUM
.	.	PUNCT
de	de	ADP
ᑕroces	ᑕrox	NOUN
durante	duro	VERB
litigiosi	litigiosi	SCONJ
dicte	dico	VERB
cantorie	cantories	NOUN
Placet	placeo	VERB
dominis	domina	NOUN
quod	qui	PRON
dominus	dominus	NOUN
Jo	Jum	NOUN
.	.	PUNCT
Goullemart	Goullemaro	ADV
sit	sum	VERB
de	de	ADP
provisione	provisio	NOUN
prout	prout	CCONJ
alii	alius	ADJ
Ordinatum	Ordinatus	NOUN
est	sum	VERB
quod	qui	PRON
$p$	$p$	ADV
de	de	ADP
peccuniis	peccunium	NOUN
repertis	repero	VERB
per	per	ADP
m	s	NOUN
.	.	PUNCT
V	V	NUM
.	.	PUNCT
de	de	ADP
ᑕroces	ᑕrox	NOUN
de	de	ADP
ᑕonflans	ᑕonflo	ADJ
tradantur	trado	VERB
magistro	magistro	NOUN
puerorum	puerus	NOUN
chori	chorior	NOUN
xl	xl	NOUN
.	.	PUNCT
scuta	scuo	NOUN
auri	aurus	VERB
f	f	ADV
.	.	PUNCT
super	super	ADP
hoc	hic	PRON
que	que	CCONJ
sibi	sui	PRON
debentur	debor	VERB
per	per	ADP
finem	finis	NOUN
suorum	suus	NOUN
compotorum	compotus	NOUN
#	#	PUNCT
Placet	placeo	VERB
dominis	dominus	NOUN
quod	quod	PRON
Jo	Jum	NOUN
.	.	PUNCT
Boucart	Boucaro	VERB
sit	sum	VERB
spé	spé	ADV
onere	onio	NOUN
eud	eus	PRON
adlisundum	adlisuo	VERB
super	super	ADP
provsione	provsio	NOUN
ipsorum	ipsus	ADJ
fiendam	fio	VERB
prou	prous	ADV
pere	pio	VERB
presento	presentus	ADJ
deputantur	deputo	VERB
domini	dominus	NOUN
Cantor	Cantor	NOUN
Josas	Josa	VERB
ᑕancellarius	ᑕancellarius	NOUN
ᗞu	ᗞus	NOUN
ᗞrac	ᗞrac	ADV
et	et	CCONJ
De	de	ADP
ᑕroces	ᑕrox	NOUN
